profile_id,name,rank,rating,country,games,wins,losses,drops,game_type
199170,dogao,4,2232,BR,459,349,110,14,1v1 Random Map
196240,TheViper,7,2207,DE,420,294,126,1,1v1 Random Map
199419,gkt_cloud,30,2074,TW,361,221,140,3,1v1 Random Map
312938,BacT,33,2060,VN,853,532,321,8,1v1 Random Map
2431776,ItsOver9000,54,2009,AR,62,39,23,1,1v1 Random Map
268565,RoR | Luca8761,67,1965,CA,619,320,299,7,1v1 Random Map
560474,Sunzets,68,1963,MX,81,58,23,2,1v1 Random Map
225365,Obadiah,77,1953,CA,484,275,209,6,1v1 Random Map
547152,Bella_Ciao,84,1933,TR,251,150,101,1,1v1 Random Map
1788064,我在时间尽头等你,86,1932,CN,456,254,202,1,1v1 Random Map
312774,Sun | Keno_,91,1926,MX,373,217,156,5,1v1 Random Map
350401,伊藤さん,95,1918,CN,18,12,6,1,1v1 Random Map
2521572,Mahya_  I  Twitch.tv,127,1866,MA,288,163,125,34,1v1 Random Map
316555,neromelnick,160,1825,CL,204,107,97,0,1v1 Random Map
1195260,Kellar,175,1807,NO,332,186,146,3,1v1 Random Map
280459,AoL_RecoN,178,1804,GB,334,187,147,3,1v1 Random Map
897060,三花六木九界通玄上仙,186,1795,CN,107,68,39,2,1v1 Random Map
453821,Macluffy,190,1787,BE,1757,906,851,22,1v1 Random Map
2526695,_63_GuAsOn_Arg,201,1775,AR,65,44,21,0,1v1 Random Map
235623,Twitch.tv | SpringTV,203,1774,US,800,436,364,14,1v1 Random Map
219493,TheSniper_AOE,207,1769,FR,1055,555,500,11,1v1 Random Map
2063382,Bobdedestructor,210,1766,DK,240,131,109,7,1v1 Random Map
1892228,KaN,212,1764,AR,79,51,28,3,1v1 Random Map
259265,chiefChing,238,1742,GB,255,147,108,0,1v1 Random Map
243287,Mustard Pudding,248,1736,CN,567,309,258,12,1v1 Random Map
332603,teutonic_tanks,258,1731,AT,47,37,10,0,1v1 Random Map
545512,你是很大ON9JAI,268,1724,NO,188,109,79,1,1v1 Random Map
238458,Barba_Amarillo.,271,1723,MX,476,257,219,4,1v1 Random Map
541010,JustAPlayer,276,1721,DE,52,40,12,0,1v1 Random Map
1829213,Falcao,278,1721,BR,145,90,55,3,1v1 Random Map
230432,steakmaster,285,1717,GB,296,165,131,2,1v1 Random Map
1189246,SC_Acti0n,309,1709,BR,180,106,74,3,1v1 Random Map
1821855,tanglang,319,1703,CN,661,348,313,4,1v1 Random Map
2419773,Pickle Rick,320,1702,DE,72,50,22,0,1v1 Random Map
208757,HeavenlyChorus,322,1701,CN,489,261,228,12,1v1 Random Map
222102,Annotoph,327,1700,DE,35,26,9,0,1v1 Random Map
2534796,NMNKING,344,1689,RU,262,146,116,1,1v1 Random Map
494384,raremome,370,1674,JP,13,12,1,0,1v1 Random Map
351793,Moonfaller,417,1654,NL,841,440,401,25,1v1 Random Map
229230,Calalpaco,433,1644,IT,360,197,163,14,1v1 Random Map
2462063,Ciclar Memb,437,1643,IT,39,19,20,0,1v1 Random Map
1097738,PuMpKiN,457,1636,GB,123,73,50,0,1v1 Random Map
624644,Holland,493,1623,NL,132,78,54,1,1v1 Random Map
1868958,tr3VS_,498,1622,BR,295,161,134,14,1v1 Random Map
1848728,yago,522,1616,ES,262,143,119,40,1v1 Random Map
1073722,Looki,529,1613,FR,590,312,278,12,1v1 Random Map
403294,Arqb | Shivansh,549,1610,IN,586,309,277,23,1v1 Random Map
615163,᠌Lambes,552,1609,BR,967,497,470,12,1v1 Random Map
631646,[mPzzA] rainManzD,569,1606,US,682,358,324,29,1v1 Random Map
2265763,_SickManCat_,575,1605,TW,34,26,8,0,1v1 Random Map
254567,bav_tarantula,580,1603,DE,54,38,16,2,1v1 Random Map
216107,[bK] guizica,585,1603,BR,481,262,219,17,1v1 Random Map
287230,Burelés,588,1602,ES,943,487,456,19,1v1 Random Map
2509215,Digger,594,1600,GB,66,44,22,0,1v1 Random Map
348134,Erge_____,595,1600,CN,241,135,106,5,1v1 Random Map
504443,****,599,1599,CN,715,367,348,67,1v1 Random Map
2547340,_HerTz___,602,1598,AR,56,39,17,3,1v1 Random Map
355871,Grinder,603,1598,RU,182,102,80,0,1v1 Random Map
274130,BIGDADDY,614,1595,FR,194,107,87,1,1v1 Random Map
1823161,Euler,622,1594,JP,240,135,105,1,1v1 Random Map
212921,Albert_Stone,627,1590,MX,27,24,3,0,1v1 Random Map
336983,Thomasbeer,656,1581,NL,474,256,218,39,1v1 Random Map
793776,GrimorG,657,1580,FR,95,57,38,2,1v1 Random Map
219663,Bujakabla,670,1577,DE,189,111,78,7,1v1 Random Map
574945,TheMole - 67,676,1575,FR,223,123,100,3,1v1 Random Map
2382926,VN_MiLLeNcOlin,678,1575,MX,75,46,29,0,1v1 Random Map
307076,bushi27,685,1574,GR,52,35,17,1,1v1 Random Map
258972,DriNkY_T,687,1573,DE,26,20,6,1,1v1 Random Map
498973,GoodMan,688,1573,GB,283,150,133,2,1v1 Random Map
1857655,ReadyFreddy,694,1573,DE,277,147,130,4,1v1 Random Map
355537,_sala,717,1567,HK,513,269,244,6,1v1 Random Map
2149041,DaRs | Cambalache_,735,1563,AR,507,264,243,4,1v1 Random Map
420486,JoBi,740,1562,NO,280,153,127,3,1v1 Random Map
401359,Twitch.com/Lord_Envidiates,750,1560,MX,277,155,122,6,1v1 Random Map
1091018,MNP,768,1556,TR,68,38,30,1,1v1 Random Map
208701,[mPzzA] K1,791,1552,IR,132,79,53,9,1v1 Random Map
910232,小四,792,1551,TW,665,348,317,11,1v1 Random Map
1184825,Edkal,806,1549,FR,376,202,174,2,1v1 Random Map
249430,Av3stan,808,1548,PT,101,58,43,1,1v1 Random Map
2262048,Spider Cop,818,1546,TR,195,105,90,8,1v1 Random Map
741271,_Ats,826,1544,BR,57,39,18,1,1v1 Random Map
233707,Brentajacied,868,1536,NL,147,87,60,1,1v1 Random Map
269023,Pichaku,872,1535,BR,18,12,6,0,1v1 Random Map
457389,Sandalen,876,1534,NO,11,9,2,0,1v1 Random Map
2449838,_悟空_WuKong,886,1533,CN,33,15,18,1,1v1 Random Map
2513626,Ibboy,903,1530,CL,25,20,5,0,1v1 Random Map
932993,G00Dfellaz-GyN,910,1528,AR,44,29,15,1,1v1 Random Map
669217,MrNiceGuy,912,1528,DE,359,193,166,3,1v1 Random Map
1650931,BAHAE,942,1525,MA,289,152,137,21,1v1 Random Map
867046,Nuno,948,1524,BR,218,119,99,6,1v1 Random Map
78611,Joanel,1015,1512,AR,369,196,173,7,1v1 Random Map
214095,Scherom,1030,1510,CH,470,249,221,6,1v1 Random Map
196005,Dufon,1037,1509,PT,542,286,256,5,1v1 Random Map
404048,TheChemist,1056,1507,US,57,31,26,1,1v1 Random Map
87617,tomorrowcomestoday,1063,1506,AR,241,135,106,7,1v1 Random Map
1780873,plop plop,1097,1502,FR,127,73,54,1,1v1 Random Map
209204,Killer_Storm_,1113,1500,IT,384,207,177,8,1v1 Random Map
1117520,Rafellipe_rlZ,1118,1499,CA,71,46,25,1,1v1 Random Map
233587,Barkovian,1129,1498,FI,576,303,273,20,1v1 Random Map
21044,The_Barto,1144,1497,CO,74,46,28,1,1v1 Random Map
226861,_Mich_,1145,1496,IT,353,185,168,2,1v1 Random Map
1859818,NK,1146,1496,SE,15,14,1,0,1v1 Random Map
209966,徐仙,1152,1495,CN,107,70,37,1,1v1 Random Map
2345306,hangemhigh,1153,1495,TR,188,102,86,2,1v1 Random Map
222418,Nightmare,1154,1495,NL,53,36,17,2,1v1 Random Map
779225,kgbrenan,1157,1494,BR,113,62,51,0,1v1 Random Map
261535,Faranight,1165,1493,ES,631,329,302,9,1v1 Random Map
261045,BlackCoffee,1170,1492,US,180,105,75,2,1v1 Random Map
208812,GriN,1174,1492,RU,318,173,145,6,1v1 Random Map
260407,GmanStreams,1195,1488,NL,41,26,15,0,1v1 Random Map
931567,Wish,1204,1487,SE,249,135,114,5,1v1 Random Map
220792,Don_Pablo,1210,1487,DE,350,186,164,4,1v1 Random Map
269503,cackle_,1216,1486,US,107,63,44,1,1v1 Random Map
1477239,noname8135,1274,1478,TW,240,127,113,12,1v1 Random Map
253068,shanavii,1336,1468,PL,182,100,82,2,1v1 Random Map
543093,Ann0r,1347,1467,DE,62,37,25,5,1v1 Random Map
221824,LEON,1353,1467,FR,181,103,78,3,1v1 Random Map
306756,TheCapeMan,1358,1467,CA,342,180,162,7,1v1 Random Map
101103,TheVuki,1363,1466,DE,36,25,11,0,1v1 Random Map
362024,Project Exile,1370,1465,DE,224,120,104,2,1v1 Random Map
120105,hchxie,1374,1464,CN,237,134,103,6,1v1 Random Map
942980,Sir_Tableflipper,1386,1463,RO,32,11,21,0,1v1 Random Map
798470,ifanzin,1392,1462,BR,357,187,170,12,1v1 Random Map
2237145,cz.jarosa,1410,1461,CZ,34,24,10,0,1v1 Random Map
2571904,Django ist doof,1465,1455,DE,12,12,0,0,1v1 Random Map
1160570,ZertoN,1467,1454,DE,145,84,61,2,1v1 Random Map
1782455,CN_Dauh,1475,1454,CN,265,147,118,11,1v1 Random Map
217871,_hugo,1477,1454,GB,495,261,234,37,1v1 Random Map
689582,Undrass,1496,1451,NO,548,288,260,127,1v1 Random Map
426007,TheGrashopper,1502,1450,NL,133,76,57,1,1v1 Random Map
226549,Bulbuci,1523,1448,RO,82,49,33,1,1v1 Random Map
1347107,Baafmeister,1545,1447,NL,50,32,18,0,1v1 Random Map
1128085,Straight outta NPL,1547,1446,NL,304,162,142,2,1v1 Random Map
215410,fine thank you,1557,1446,CN,57,39,18,2,1v1 Random Map
961262,Josefromspain,1559,1445,US,315,168,147,14,1v1 Random Map
209316,Szyber,1561,1445,PL,277,154,123,6,1v1 Random Map
1450147,ZondaR,1598,1442,US,40,26,14,0,1v1 Random Map
896261,[DD] Flempopo,1602,1441,DK,338,175,163,3,1v1 Random Map
2094035,紅色9,1615,1441,BE,201,109,92,1,1v1 Random Map
541547,Philoepe [GER],1622,1440,DE,135,77,58,0,1v1 Random Map
1520958,dreibasti,1634,1439,DE,109,63,46,0,1v1 Random Map
540993,Joker,1639,1438,DE,101,61,40,3,1v1 Random Map
2520445,TheVipa,1653,1436,BR,22,15,7,0,1v1 Random Map
358370,Faultier321,1657,1436,DE,242,128,114,13,1v1 Random Map
1826067,Fly like Django,1659,1436,DE,270,146,124,2,1v1 Random Map
1715442,ObtuseHawk,1677,1435,US,163,88,75,1,1v1 Random Map
255233,queronte,1681,1434,CL,166,92,74,4,1v1 Random Map
293743,Marthyn,1704,1432,AR,24,18,6,0,1v1 Random Map
2681205,Deus vult,1709,1431,US,11,11,0,0,1v1 Random Map
500274,BonanaKing,1719,1430,SE,62,39,23,0,1v1 Random Map
2320426,Mginner,1722,1430,MX,29,21,8,1,1v1 Random Map
2230668,tobedq,1723,1430,DE,15,13,2,0,1v1 Random Map
286096,Mario,1730,1429,DE,212,116,96,1,1v1 Random Map
377935,Yo,1738,1429,FR,274,147,127,6,1v1 Random Map
2394084,Pikeman,1793,1424,AR,136,75,61,3,1v1 Random Map
242134,Kieronortti,1810,1422,FI,381,202,179,34,1v1 Random Map
231489,Tiến Sĩ Lê Thành Sách,1812,1422,VN,246,129,117,11,1v1 Random Map
226140,PhantasticPhil,1813,1422,AT,134,78,56,4,1v1 Random Map
918734,andychen662000,1828,1420,TW,263,141,122,6,1v1 Random Map
608038,clod9353,1841,1419,IT,76,44,32,5,1v1 Random Map
546202,Bourbon Jr.,1842,1419,SA,150,84,66,1,1v1 Random Map
222365,Akers,1844,1419,US,57,29,28,0,1v1 Random Map
1150604,Fatihaydemir38,1883,1415,NL,104,59,45,10,1v1 Random Map
2188446,どるみーる,1888,1415,JP,80,47,33,0,1v1 Random Map
1655898,[KM]FrosT,1903,1414,CL,224,123,101,3,1v1 Random Map
2126902,LiLi,1912,1413,TR,481,250,231,3,1v1 Random Map
198887,luki00thesecond,1917,1412,AT,434,227,207,5,1v1 Random Map
210855,M4lt3,1935,1411,DE,192,107,85,5,1v1 Random Map
242555,Herzog der Normandie,1936,1411,DE,234,125,109,13,1v1 Random Map
265163,I_AM_CHRIS,1945,1410,CO,242,132,110,13,1v1 Random Map
2116604,squeaker,1953,1410,GB,193,106,87,1,1v1 Random Map
17166,Lay'sCola,1959,1410,CN,342,183,159,28,1v1 Random Map
283554,Monkey Boy,1960,1409,DE,168,95,73,0,1v1 Random Map
2075973,VN_THoMaS,1970,1409,ES,26,19,7,0,1v1 Random Map
1890141,Svriz,1971,1409,CL,84,44,40,0,1v1 Random Map
1030879,aegus,1974,1409,BE,253,132,121,2,1v1 Random Map
1319221,TheDiaper,1985,1408,CA,145,80,65,2,1v1 Random Map
252660,CitizenAbel,1989,1407,DE,55,29,26,1,1v1 Random Map
375354,TimmeahNL,1998,1407,NL,92,57,35,0,1v1 Random Map
2680420,Tuti,2034,1405,FR,10,10,0,0,1v1 Random Map
706803,-Accelerator,2046,1404,US,35,24,11,0,1v1 Random Map
537486,Snikolay,2050,1404,NL,82,48,34,0,1v1 Random Map
214558,Fox,2059,1403,US,302,161,141,3,1v1 Random Map
564024,LameBoy杉浦,2062,1403,JP,21,16,5,0,1v1 Random Map
1191728,TheSlim3,2082,1402,US,114,67,47,2,1v1 Random Map
1741565,Neza___,2096,1401,MX,47,28,19,0,1v1 Random Map
251421,MaesterFAB,2102,1400,NA,29,21,8,1,1v1 Random Map
574143,Charles V le Sage,2103,1400,FR,445,235,210,6,1v1 Random Map
223262,Buntar',2111,1400,LV,112,67,45,2,1v1 Random Map
1867537,galigeigei44,2115,1400,CN,27,19,8,2,1v1 Random Map
445587,htolS,2125,1399,US,221,120,101,3,1v1 Random Map
2432919,Returned_Legend,2127,1399,US,30,20,10,1,1v1 Random Map
2132771,Biohazard,2128,1399,CH,162,91,71,0,1v1 Random Map
344078,yushi,2129,1399,GB,50,32,18,0,1v1 Random Map
2595751,Moctezuma,2139,1398,FR,180,95,85,1,1v1 Random Map
289624,_guga,2147,1398,BR,118,68,50,1,1v1 Random Map
285635,Idaguy,2182,1394,CA,130,66,64,2,1v1 Random Map
211468,a220541515,2186,1394,TW,774,400,374,14,1v1 Random Map
2329473,Ryszko,2223,1392,HU,54,32,22,0,1v1 Random Map
493574,Death0rGlory,2231,1391,DE,54,33,21,0,1v1 Random Map
2630006,bucknucky,2233,1391,AU,13,11,2,1,1v1 Random Map
1427042,Boxxhenizeel,2241,1391,BG,338,179,159,3,1v1 Random Map
1752510,TheJokeer,2252,1390,DE,218,117,101,3,1v1 Random Map
703782,Tilmarod,2259,1389,ES,72,45,27,0,1v1 Random Map
2274841,clp01234544 no notification,2266,1389,HK,65,38,27,2,1v1 Random Map
309422,monoscout999,2272,1388,AR,60,37,23,4,1v1 Random Map
976625,flowaway4,2276,1387,CH,120,66,54,2,1v1 Random Map
2413974,Roggy,2280,1387,TR,72,40,32,0,1v1 Random Map
2243723,House Reyne,2281,1387,AU,20,16,4,0,1v1 Random Map
917389,T.BLADE,2289,1386,US,192,106,86,4,1v1 Random Map
503803,Yggdrasil,2299,1386,CH,545,283,262,5,1v1 Random Map
238961,pEp,2312,1385,ES,84,52,32,1,1v1 Random Map
2386022,HACHIGERI,2331,1384,JP,59,35,24,1,1v1 Random Map
1322487,PlusEV,2353,1383,DE,262,141,121,1,1v1 Random Map
236944,Zbysio,2391,1380,PL,254,137,117,2,1v1 Random Map
778725,Skrillll,2402,1379,MA,24,13,11,0,1v1 Random Map
2591989,Sharm,2408,1379,FR,20,15,5,0,1v1 Random Map
778801,Frrock,2416,1378,US,53,34,19,2,1v1 Random Map
1968372,Rompe_CU,2422,1378,AR,46,31,15,1,1v1 Random Map
1074476,PurePudding,2424,1377,TW,189,98,91,5,1v1 Random Map
251775,_MidGard_,2469,1374,IT,34,23,11,1,1v1 Random Map
403359,BossRice,2475,1374,VN,331,174,157,21,1v1 Random Map
2445213,WhiteBird,2476,1374,ES,43,27,16,0,1v1 Random Map
2125674,Waldorf,2479,1374,DE,14,11,3,0,1v1 Random Map
316084,OMurchu,2481,1374,DE,95,52,43,4,1v1 Random Map
1578367,hamza.asif95,2497,1373,AR,25,18,7,0,1v1 Random Map
973305,Cryster,2502,1372,CH,16,12,4,0,1v1 Random Map
201179,MazZ,2520,1372,AR,127,70,57,1,1v1 Random Map
423208,Francescam,2527,1371,FR,394,208,186,14,1v1 Random Map
227368,VforKickAss,2547,1370,DE,45,30,15,0,1v1 Random Map
218068,[KGR]Mustang,2559,1370,DE,362,187,175,4,1v1 Random Map
605547,Kwai,2595,1367,CA,54,34,20,1,1v1 Random Map
388611,nachoforlano,2598,1367,AR,203,106,97,3,1v1 Random Map
913154,evgeny93,2605,1366,IL,92,51,41,1,1v1 Random Map
635875,rua！,2609,1366,CN,231,126,105,6,1v1 Random Map
1926454,14,2635,1365,TW,237,124,113,2,1v1 Random Map
380971,w4ld1nh0e,2645,1364,NA,508,270,238,5,1v1 Random Map
2032321,capitano,2648,1364,TR,429,220,209,6,1v1 Random Map
376789,schopeng,2684,1362,DE,204,112,92,5,1v1 Random Map
619891,abiyubi,2698,1361,TR,141,77,64,1,1v1 Random Map
2030683,VICE PRESIDENT MIKE PENCE,2712,1360,GB,136,72,64,3,1v1 Random Map
1514640,ShadowWalker,2713,1360,PL,43,22,21,0,1v1 Random Map
496227,Mr_T0,2724,1359,DE,165,93,72,3,1v1 Random Map
409680,LEEEROY JEEENKINS!!!,2725,1359,US,24,11,13,0,1v1 Random Map
2724143,StormBreakeR,2726,1359,BR,11,7,4,0,1v1 Random Map
902557,Grootmeester,2737,1358,NL,80,47,33,0,1v1 Random Map
1536830,ema_tandil,2748,1358,AR,18,13,5,0,1v1 Random Map
2423861,湖南第一突破口,2759,1357,CN,10,6,4,0,1v1 Random Map
336400,Atlas,2762,1357,GB,292,153,139,2,1v1 Random Map
1247388,w(oO)t,2767,1357,NZ,17,13,4,0,1v1 Random Map
387323,Mannferd,2778,1356,DE,187,101,86,5,1v1 Random Map
398279,Visage main,2808,1354,CA,127,72,55,0,1v1 Random Map
386571,Go-Toba,2809,1354,GB,52,32,20,0,1v1 Random Map
2044492,Soldadito de Plomo,2832,1353,MX,406,204,202,1,1v1 Random Map
1790170,The_Leccoc,2838,1353,BR,405,208,197,9,1v1 Random Map
1450849,test123,2842,1353,SE,67,39,28,0,1v1 Random Map
275589,AceW,2847,1352,DE,542,281,261,7,1v1 Random Map
971400,BlueFish,2850,1352,AU,11,10,1,1,1v1 Random Map
214278,Templar,2870,1351,BR,208,113,95,6,1v1 Random Map
248311,Belle-couille,2875,1351,FR,36,15,21,1,1v1 Random Map
364336,Nemo,2905,1350,IT,41,26,15,0,1v1 Random Map
827454,Drac- Charles,2915,1349,MX,303,162,141,7,1v1 Random Map
1326038,RESİDENT TÜRBANLI : BOMBA,2934,1349,TR,155,87,68,2,1v1 Random Map
884491,Lord of cheese,2959,1347,IN,341,181,160,5,1v1 Random Map
401440,qwertyman,2968,1347,AU,188,101,87,0,1v1 Random Map
1496695,BrokeBack,2979,1347,DE,33,21,12,0,1v1 Random Map
2170874,IamRuDaY,3006,1345,FR,66,39,27,0,1v1 Random Map
214758,OleBambole,3011,1344,DE,53,36,17,0,1v1 Random Map
1840657,Craidon,3024,1344,CO,222,124,98,9,1v1 Random Map
317612,edesa1000,3026,1344,KR,179,100,79,1,1v1 Random Map
2624148,Tigger King,3034,1343,AR,51,32,19,3,1v1 Random Map
437112,Schubert,3051,1342,TW,95,53,42,5,1v1 Random Map
1288929,nukehat,3077,1341,US,709,366,343,12,1v1 Random Map
265239,Extracheekij,3082,1340,IT,304,165,139,9,1v1 Random Map
1414997,TaylorSwift.<3,3125,1339,US,214,111,103,6,1v1 Random Map
1992969,Strelok,3139,1338,US,14,11,3,0,1v1 Random Map
2267133,白腳黑貓,3154,1337,TW,12,4,8,1,1v1 Random Map
2147194,Glantonne,3155,1337,CA,61,36,25,0,1v1 Random Map
1934042,Abyss Vandzy,3180,1336,NA,183,105,78,22,1v1 Random Map
1773354,七張米粉湯,3181,1336,TW,243,126,117,4,1v1 Random Map
764918,Zaryab,3189,1335,PK,24,9,15,0,1v1 Random Map
898389,?,3250,1332,CL,300,165,135,33,1v1 Random Map
596642,Benjaaam,3272,1331,FR,185,103,82,6,1v1 Random Map
593703,lsa,3273,1331,CN,132,78,54,6,1v1 Random Map
249344,StrikeOut[MD],3292,1330,DE,552,286,266,11,1v1 Random Map
284002,zm,3328,1328,US,412,215,197,8,1v1 Random Map
213427,Subzer0,3330,1328,US,27,18,9,0,1v1 Random Map
253973,The Chancellor,3370,1326,GB,28,16,12,0,1v1 Random Map
166935,pFunk,3372,1326,AR,385,199,186,2,1v1 Random Map
530448,[KoA]BloodShed,3374,1326,AU,41,23,18,0,1v1 Random Map
2262981,Anette,3379,1326,DE,27,17,10,0,1v1 Random Map
9605,ibawly,3389,1326,CN,62,36,26,0,1v1 Random Map
1118621,marvD,3392,1325,DE,409,215,194,4,1v1 Random Map
832726,SuperSysel,3397,1325,CZ,52,31,21,0,1v1 Random Map
1478473,AlExIsAwEsOmE,3413,1325,US,24,16,8,1,1v1 Random Map
263644,cidovsky,3423,1324,BR,44,27,17,1,1v1 Random Map
339170,Kuo,3438,1324,TW,42,27,15,0,1v1 Random Map
1415080,Bossid,3442,1324,EE,225,117,108,2,1v1 Random Map
627899,brkataman,3451,1323,TR,43,28,15,1,1v1 Random Map
422452,IvaS,3452,1323,ES,98,50,48,0,1v1 Random Map
280228,Tigry,3464,1322,DE,43,26,17,0,1v1 Random Map
233981,flo.menacher,3472,1322,DE,147,78,69,2,1v1 Random Map
1792275,edo.andreotti,3481,1322,IT,616,314,302,14,1v1 Random Map
1047969,Elvemage,3485,1321,PT,59,32,27,0,1v1 Random Map
508796,Emi_Vazquez,3492,1321,AR,17,11,6,0,1v1 Random Map
228855,TradeR,3495,1321,ES,137,77,60,3,1v1 Random Map
272166,whitebread61,3510,1320,US,194,104,90,1,1v1 Random Map
2202329,Ser Chris,3521,1320,DE,100,56,44,0,1v1 Random Map
1334547,Filip,3533,1320,BE,188,100,88,1,1v1 Random Map
981941,Nizzdramati,3536,1319,CZ,151,83,68,3,1v1 Random Map
255199,WizardHsc,3542,1319,BR,263,141,122,9,1v1 Random Map
505787,noobsmile,3547,1319,VN,331,172,159,7,1v1 Random Map
384906,RTK{S} | viscoussatsuma,3554,1319,GB,189,103,86,0,1v1 Random Map
255500,Seven,3566,1318,RS,170,91,79,2,1v1 Random Map
250307,Elabayalde,3584,1317,PE,370,191,179,17,1v1 Random Map
260786,Logan,3632,1315,PL,100,59,41,2,1v1 Random Map
616203,Son Of Osiris,3637,1315,NA,63,37,26,1,1v1 Random Map
1631354,Wormwood,3650,1315,US,635,322,313,8,1v1 Random Map
2541112,lube the kid,3663,1314,ES,32,20,12,0,1v1 Random Map
2495860,jonathansoegaard,3664,1314,DK,52,31,21,1,1v1 Random Map
1507571,Frietback,3674,1314,NL,63,37,26,7,1v1 Random Map
857098,TiJu,3680,1313,DE,370,199,171,68,1v1 Random Map
853553,Cloud,3681,1313,AU,31,19,12,0,1v1 Random Map
382055,Poolparty,3690,1313,AR,32,17,15,1,1v1 Random Map
360208,ZerunBeer,3691,1313,BR,192,103,89,1,1v1 Random Map
1176082,FLAVIUS__AETIUS,3698,1312,GR,514,262,252,4,1v1 Random Map
1048534,MP,3701,1312,AE,16,12,4,0,1v1 Random Map
584612,KingofManzairra,3709,1312,CA,322,169,153,6,1v1 Random Map
2056636,TacheE,3720,1312,MX,22,15,7,0,1v1 Random Map
493651,朱颜辞镜花辞树,3731,1311,CN,301,158,143,13,1v1 Random Map
1914868,Goss,3740,1311,FR,142,79,63,15,1v1 Random Map
206536,ZKWD,3781,1309,FR,389,205,184,7,1v1 Random Map
348832,TurdSandwich,3800,1309,BE,263,140,123,14,1v1 Random Map
1743347,FenixooEM,3805,1309,NA,181,100,81,8,1v1 Random Map
1563274,Karabas,3808,1309,UA,87,45,42,0,1v1 Random Map
278820,Uprootednut,3817,1308,GB,281,149,132,4,1v1 Random Map
553794,sunsetflyer,3820,1308,US,131,73,58,1,1v1 Random Map
2610180,BudSpencerOR,3825,1308,NA,116,61,55,8,1v1 Random Map
1036384,Saladin45,3861,1306,TN,409,209,200,45,1v1 Random Map
289559,Dr.EddyG,3882,1306,US,76,43,33,2,1v1 Random Map
953623,BYD1211,3889,1305,HK,116,64,52,5,1v1 Random Map
947019,HeuristicMagic,3890,1305,US,72,43,29,1,1v1 Random Map
236788,holland89,3895,1305,ES,372,190,182,14,1v1 Random Map
18139,Jotschi,3897,1305,AT,246,132,114,1,1v1 Random Map
843735,Parlorage,3913,1304,FR,91,53,38,3,1v1 Random Map
782900,不再少年,3917,1304,CN,107,56,51,3,1v1 Random Map
257292,Degaussed,3918,1304,GB,487,254,233,2,1v1 Random Map
544921,-----------,3920,1304,PT,344,181,163,22,1v1 Random Map
230085,Marcio Junior,3922,1304,BR,194,106,88,6,1v1 Random Map
2327650,Thomas White,3928,1304,CL,10,4,6,0,1v1 Random Map
223826,Gurkerllift,3930,1304,AT,286,153,133,3,1v1 Random Map
372041,Ten of Clubs,3931,1304,FR,27,15,12,0,1v1 Random Map
40856,CheeseKing,3942,1303,CH,132,71,61,6,1v1 Random Map
1421273,RoZZoR,3962,1303,DE,51,29,22,0,1v1 Random Map
622587,[DoT] Dagorlad,3969,1302,MX,20,14,6,0,1v1 Random Map
2710890,Oude bok,3978,1302,NL,23,15,8,1,1v1 Random Map
2304691,sace_do_age,4003,1301,BR,199,102,97,0,1v1 Random Map
222385,-KiMOsaBE-,4004,1301,DE,11,8,3,0,1v1 Random Map
246031,Jabob,4021,1300,DE,196,104,92,3,1v1 Random Map
223624,[Fc],4028,1300,BO,86,49,37,2,1v1 Random Map
1723506,Billy,4035,1300,AU,11,9,2,0,1v1 Random Map
212159,Runnin_Gag,4047,1299,CH,359,188,171,22,1v1 Random Map
2686141,hang9090,4056,1299,HK,11,4,7,0,1v1 Random Map
1839036,Wayman92,4061,1299,DE,108,60,48,0,1v1 Random Map
539495,3ScarFac3,4081,1298,DE,67,39,28,0,1v1 Random Map
2365106,Weevers_,4089,1298,FR,15,11,4,0,1v1 Random Map
985630,BaronAoe,4102,1297,TR,180,92,88,5,1v1 Random Map
908968,Жin,4103,1297,CH,544,284,260,45,1v1 Random Map
2321523,jessefakinjeyms,4117,1297,TR,78,46,32,0,1v1 Random Map
771735,Ray-Ray 火,4140,1296,BG,339,181,158,7,1v1 Random Map
468386,Tom Jobim,4148,1296,BR,59,35,24,3,1v1 Random Map
465094,Jagger,4149,1296,AR,169,91,78,3,1v1 Random Map
431805,Rabbit Senpai,4151,1296,TR,139,75,64,1,1v1 Random Map
335549,arranley,4158,1296,SK,34,23,11,1,1v1 Random Map
2176958,snackerino,4182,1295,DE,151,83,68,0,1v1 Random Map
1916782,spooky zoopro,4183,1295,DE,14,5,9,0,1v1 Random Map
316834,FishCakes,4188,1295,US,37,24,13,0,1v1 Random Map
1439621,The Rohirrim,4189,1295,AU,18,11,7,0,1v1 Random Map
1986910,Sacredsilence,4212,1294,TR,20,14,6,0,1v1 Random Map
691855,Ramelouille,4293,1290,BE,56,34,22,1,1v1 Random Map
2602967,yunito000,4300,1290,CL,18,13,5,0,1v1 Random Map
2301645,inmortalZ,4303,1290,ES,12,5,7,0,1v1 Random Map
202241,Mama,4315,1289,CA,24,18,6,0,1v1 Random Map
774535,zero,4317,1289,FR,118,64,54,3,1v1 Random Map
1702816,Clouclou666,4330,1289,FR,97,56,41,0,1v1 Random Map
1399027,Colem,4333,1289,FR,45,30,15,0,1v1 Random Map
282125,AkhiE,4336,1288,FR,80,45,35,0,1v1 Random Map
279036,m0re,4338,1288,ES,282,147,135,1,1v1 Random Map
79786,JaMa42,4341,1288,DE,57,34,23,2,1v1 Random Map
1260835,GGino,4363,1288,GB,170,88,82,2,1v1 Random Map
2501248,Paddy,4375,1287,TW,13,10,3,0,1v1 Random Map
1264020,Isabella,4388,1287,DE,24,19,5,2,1v1 Random Map
242461,BigAl,4397,1286,US,607,311,296,3,1v1 Random Map
2359209,Sethmo,4403,1286,DE,15,5,10,1,1v1 Random Map
265901,Pessimistic Guy,4419,1285,AT,151,82,69,3,1v1 Random Map
1473663,Edorsa,4438,1285,TR,233,123,110,3,1v1 Random Map
234095,lMercyAOE,4453,1284,AR,24,15,9,2,1v1 Random Map
2050591,drauler,4463,1284,BR,24,16,8,2,1v1 Random Map
1063974,Soraz,4470,1283,US,58,34,24,0,1v1 Random Map
2419519,Tikétack,4482,1283,FR,49,30,19,4,1v1 Random Map
1965681,Zeive,4488,1283,ES,16,5,11,0,1v1 Random Map
2061131,Jesse Pinkman,4516,1282,CL,56,32,24,2,1v1 Random Map
628541,HuK,4532,1281,US,20,11,9,0,1v1 Random Map
2504771,harmanpreet0,4542,1281,CA,214,111,103,2,1v1 Random Map
381282,vyas_23,4544,1281,GB,52,31,21,0,1v1 Random Map
275741,eGGz,4556,1280,CO,106,59,47,2,1v1 Random Map
1105680,YOUrBADimMAD,4577,1279,DE,47,28,19,0,1v1 Random Map
613999,]AtF[  DaDumbazz O.o,4586,1279,CA,197,103,94,4,1v1 Random Map
354755,-DoCa- RageMan,4616,1278,NL,56,28,28,1,1v1 Random Map
623162,Blue_coffee,4650,1276,US,45,26,19,2,1v1 Random Map
1931804,luckywick,4665,1276,FR,14,10,4,0,1v1 Random Map
1057622,Armageddon,4674,1275,CH,10,8,2,1,1v1 Random Map
506834,_CAXCAN_,4683,1275,MX,94,48,46,1,1v1 Random Map
979474,Bacdou,4699,1274,FR,773,394,379,14,1v1 Random Map
744693,Ruddybird,4732,1273,US,81,44,37,0,1v1 Random Map
1866331,HeKooro,4744,1273,NO,57,35,22,2,1v1 Random Map
769600,Yosaii,4758,1272,FR,229,124,105,4,1v1 Random Map
673132,Rasco,4759,1272,FR,24,15,9,1,1v1 Random Map
216839,HartzFear,4781,1272,DE,22,16,6,0,1v1 Random Map
404892,uppsalamala,4803,1271,US,142,78,64,3,1v1 Random Map
345654,area51-x,4811,1271,AE,10,7,3,0,1v1 Random Map
1085218,MicKey,4821,1270,DE,68,35,33,3,1v1 Random Map
272531,sacroima,4856,1269,CH,36,22,14,1,1v1 Random Map
863791,FerV,4857,1269,ES,68,38,30,0,1v1 Random Map
229224,Knight_eater,4869,1269,DE,193,105,88,2,1v1 Random Map
2694118,Saunder,4900,1268,AR,17,4,13,0,1v1 Random Map
1442217,Waddafak,4913,1268,NL,269,143,126,10,1v1 Random Map
1184908,yanyuxin2,4917,1268,CN,104,60,44,4,1v1 Random Map
323254,Zaid Khan,4934,1267,US,190,103,87,24,1v1 Random Map
247359,Stavros,4946,1266,GR,38,22,16,0,1v1 Random Map
2652782,Magnum XL,4949,1266,AT,55,33,22,0,1v1 Random Map
2264287,General_Anoosh,4956,1266,IN,144,76,68,1,1v1 Random Map
293417,Wildey,5005,1265,GB,70,40,30,2,1v1 Random Map
280436,Abdel,5009,1264,MX,19,13,6,0,1v1 Random Map
1879906,WaffleBasket,5035,1264,NL,28,17,11,0,1v1 Random Map
627227,Кокоско,5042,1263,BG,452,233,219,42,1v1 Random Map
226606,Zorkos,5050,1263,FR,184,100,84,3,1v1 Random Map
1753021,ThomJohnson,5089,1262,BE,63,36,27,1,1v1 Random Map
1722459,Dr_Scrotus,5090,1262,DE,94,49,45,0,1v1 Random Map
1577906,pekkakana,5091,1262,FI,184,96,88,8,1v1 Random Map
1469609,Carpect,5092,1262,FR,39,23,16,0,1v1 Random Map
624038,Bagpipe,5100,1261,DE,70,42,28,3,1v1 Random Map
540428,Muchou_Tsai,5103,1261,TW,380,196,184,3,1v1 Random Map
536263,bosaap12,5104,1261,NL,45,27,18,1,1v1 Random Map
437806,SmokizzMTL,5106,1261,NA,155,86,69,7,1v1 Random Map
256937,TheHound,5121,1260,DE,263,138,125,3,1v1 Random Map
256300,Crassus,5122,1260,DE,12,9,3,0,1v1 Random Map
323379,Kaos,5142,1260,AU,86,48,38,2,1v1 Random Map
317110,Lazy_man,5143,1260,CN,200,109,91,4,1v1 Random Map
281737,Vertical Vertigo,5152,1259,CA,227,118,109,13,1v1 Random Map
2373778,ZZZ,5170,1259,CN,80,51,29,1,1v1 Random Map
2175394,^^,5173,1259,GB,37,25,12,1,1v1 Random Map
1940208,Drey,5178,1259,FR,12,6,6,0,1v1 Random Map
1867951,reeNN;b  «XJ.SPANISH»,5179,1259,DE,193,99,94,1,1v1 Random Map
858498,Despir,5190,1258,FR,12,7,5,0,1v1 Random Map
713253,joosepkarp,5192,1258,EE,275,148,127,3,1v1 Random Map
242306,Master Silver,5194,1258,DE,13,9,4,0,1v1 Random Map
338588,Khal Kamsma,5211,1258,NL,425,215,210,2,1v1 Random Map
924780,Jedi Inting,5222,1257,DE,128,68,60,0,1v1 Random Map
377758,Buckweedz,5236,1257,DE,259,135,124,3,1v1 Random Map
283029,Monsieur Verdoux,5247,1256,DE,20,12,8,1,1v1 Random Map
557790,cab1enzo,5258,1256,AR,169,91,78,4,1v1 Random Map
330510,Dysnomian,5272,1256,NZ,188,101,87,1,1v1 Random Map
2063614,JACKO,5301,1255,GB,48,29,19,0,1v1 Random Map
1349656,Depsi,5309,1255,FR,595,308,287,5,1v1 Random Map
1124892,不会塔爆,5313,1254,CN,204,110,94,10,1v1 Random Map
272825,PurgeFIN,5315,1254,FI,281,149,132,4,1v1 Random Map
240210,CapCalamari,5320,1254,AT,141,76,65,3,1v1 Random Map
1063725,Indemonkable,5348,1253,US,132,67,65,2,1v1 Random Map
272123,Birdman!,5350,1253,BR,10,8,2,1,1v1 Random Map
644309,LouDELARCHE,5354,1253,NA,167,93,74,12,1v1 Random Map
2188040,Shanks,5366,1253,TR,75,41,34,0,1v1 Random Map
895514,Fabián,5386,1252,CR,20,13,7,0,1v1 Random Map
482295,假球卡王姆,5394,1252,HK,81,45,36,1,1v1 Random Map
2475737,oguzhan_g,5399,1252,TR,47,24,23,0,1v1 Random Map
223002,edpzdn,5406,1252,TR,46,28,18,1,1v1 Random Map
325596,prankill,5410,1252,US,48,27,21,0,1v1 Random Map
1349498,Thomas92,5413,1252,FR,259,135,124,37,1v1 Random Map
2304981,IErtugrul BeyI,5428,1251,TR,22,15,7,0,1v1 Random Map
222022,Kusihe,5453,1250,FR,50,33,17,3,1v1 Random Map
736696,Necrosys,5478,1249,FR,201,106,95,3,1v1 Random Map
2177743,Labude_aoe,5487,1249,DE,62,34,28,1,1v1 Random Map
330481,gil,5495,1249,AU,416,215,201,2,1v1 Random Map
1911983,_SenSeY_StorM_,5531,1248,MX,18,12,6,0,1v1 Random Map
1875166,Batpapou,5560,1247,FR,30,18,12,1,1v1 Random Map
285066,Paderator,5569,1246,DE,749,384,365,35,1v1 Random Map
472600,Formaggio,5588,1246,AU,44,26,18,2,1v1 Random Map
1090500,Kornflexe,5615,1245,NA,338,192,146,11,1v1 Random Map
267387,Yahpp,5619,1245,PE,245,126,119,0,1v1 Random Map
731347,koudepinda,5625,1245,NL,101,52,49,2,1v1 Random Map
2060189,Korkhov,5644,1245,FR,117,62,55,0,1v1 Random Map
1963663,neverdowngogogo,5647,1245,CA,111,57,54,0,1v1 Random Map
1736148,xXxAlessioxXx,5652,1245,NA,82,50,32,1,1v1 Random Map
211503,YertleTheTurtle,5665,1244,NL,183,96,87,1,1v1 Random Map
244776,Havada,5670,1244,PL,17,12,5,0,1v1 Random Map
609696,[AOG]Oppy96,5671,1244,ES,106,56,50,0,1v1 Random Map
2471688,G0ldenFir3,5679,1244,DE,51,31,20,0,1v1 Random Map
2461088,TheSon,5680,1244,VN,14,7,7,0,1v1 Random Map
1871932,LeBoomJames,5727,1243,DE,10,8,2,0,1v1 Random Map
1817704,明月千堆雪,5728,1243,CN,133,72,61,1,1v1 Random Map
2593834,knightville,5757,1242,GB,33,19,14,3,1v1 Random Map
2520659,meme,5762,1242,US,13,10,3,1,1v1 Random Map
316932,Perfect Roe,5770,1242,NZ,201,108,93,1,1v1 Random Map
2424456,Tav3rnier,5793,1241,FR,16,11,5,0,1v1 Random Map
1765918,good ol' Malt,5801,1241,DE,34,20,14,0,1v1 Random Map
728455,mshep23,5817,1240,US,49,28,21,0,1v1 Random Map
860011,mrprov,5842,1239,IT,270,140,130,3,1v1 Random Map
2100784,S. Boom.,5861,1239,BE,61,33,28,2,1v1 Random Map
624437,ölfysn,5880,1238,DE,134,71,63,6,1v1 Random Map
2490568,RaydoxBTP,5889,1238,NA,24,16,8,0,1v1 Random Map
112720,Aquarius XII,5892,1238,DE,399,207,192,14,1v1 Random Map
312896,chira666,5903,1238,RU,177,93,84,4,1v1 Random Map
294058,Quentin Catatonii,5907,1238,US,17,12,5,0,1v1 Random Map
273618,vready92,5909,1237,DE,124,67,57,3,1v1 Random Map
2598794,RPM,5945,1236,MX,47,27,20,2,1v1 Random Map
2562188,Letz go,5946,1236,NL,14,11,3,0,1v1 Random Map
1263159,Bertie Wodehouse,5963,1236,AU,98,53,45,0,1v1 Random Map
2012897,Bazing Hood,5983,1235,ES,166,90,76,1,1v1 Random Map
312823,Vindi,6054,1233,US,42,26,16,0,1v1 Random Map
1341617,The real legend,6059,1233,DE,173,93,80,4,1v1 Random Map
1233083,Coach,6060,1233,AR,77,43,34,9,1v1 Random Map
1201823,cheetah,6061,1233,DE,10,7,3,0,1v1 Random Map
279492,Dkastro,6064,1232,CL,311,160,151,5,1v1 Random Map
1019235,Matz,6067,1232,DE,39,23,16,1,1v1 Random Map
684614,pooplord,6071,1232,US,227,119,108,60,1v1 Random Map
620610,DuDi,6073,1232,PL,58,30,28,4,1v1 Random Map
1848121,Samplify,6166,1230,US,122,69,53,0,1v1 Random Map
1203116,mausrr,6182,1230,DE,12,9,3,0,1v1 Random Map
1018252,CupcakeServant,6185,1229,FR,35,22,13,0,1v1 Random Map
818086,Dome,6191,1229,FI,188,98,90,9,1v1 Random Map
247690,Leppard,6198,1229,GB,16,9,7,0,1v1 Random Map
581759,DasLetzte,6202,1229,DE,610,312,298,48,1v1 Random Map
355035,currycurry,6248,1228,SE,86,48,38,0,1v1 Random Map
219108,Volrath,6250,1228,CO,472,243,229,12,1v1 Random Map
1093942,BerserkPaladin,6261,1227,US,39,22,17,1,1v1 Random Map
718485,Rodolink,6271,1227,FR,111,63,48,0,1v1 Random Map
467350,Sirean_army,6321,1226,US,13,8,5,0,1v1 Random Map
2166771,deadboi,6328,1226,BE,41,27,14,0,1v1 Random Map
2198171,MonkRock,6362,1225,AU,34,16,18,1,1v1 Random Map
2151359,Ober,6363,1225,AR,17,11,6,0,1v1 Random Map
1882768,Mad Dog,6366,1225,CA,280,149,131,13,1v1 Random Map
2629093,Sebag007,6392,1224,CL,70,38,32,0,1v1 Random Map
1778379,404,6404,1224,IN,239,122,117,2,1v1 Random Map
1756665,mesutbakirci91,6405,1224,TR,610,309,301,32,1v1 Random Map
1479588,Jokakutihuti,6410,1224,FI,72,43,29,0,1v1 Random Map
658281,Papzak,6422,1223,NL,50,27,23,1,1v1 Random Map
305280,BigO,6443,1223,US,185,102,83,13,1v1 Random Map
592729,nirovaka,6455,1222,NO,24,13,11,0,1v1 Random Map
450261,IdleBrain,6457,1222,BR,67,39,28,1,1v1 Random Map
327782,Icarium Rage,6468,1222,AU,35,22,13,2,1v1 Random Map
730394,SNWY4,6492,1221,GB,43,24,19,1,1v1 Random Map
250274,AtomicMuffin,6494,1221,IT,405,211,194,16,1v1 Random Map
2111730,samsonice,6509,1221,DE,29,19,10,3,1v1 Random Map
195408,ChampionRevolution,6521,1221,TW,86,48,38,3,1v1 Random Map
259840,skinnyplayboy,6534,1220,DE,267,139,128,2,1v1 Random Map
540324,Tk™ El Stereo,6537,1220,CO,185,96,89,10,1v1 Random Map
437598,Pieden,6538,1220,DE,19,11,8,1,1v1 Random Map
209432,PingPongCirc,6539,1220,CA,391,200,191,2,1v1 Random Map
221900,billiger_jakob,6549,1220,DE,216,113,103,8,1v1 Random Map
1743862,☺ As$isT.,6554,1220,SI,59,29,30,0,1v1 Random Map
274990,Falco,6572,1219,DE,32,20,12,1,1v1 Random Map
213114,hiiwave,6574,1219,TW,30,18,12,0,1v1 Random Map
382385,Docteur.NoTime,6591,1219,FR,15,10,5,0,1v1 Random Map
2353770,Pepe,6592,1219,AR,27,17,10,0,1v1 Random Map
219508,Blubbi,6599,1219,DE,52,30,22,2,1v1 Random Map
305995,aoe2hostage,6602,1219,US,527,273,254,13,1v1 Random Map
1403764,Javi_Venta,6604,1219,UY,62,28,34,1,1v1 Random Map
518920,CoK_a_cola,6621,1218,DE,18,12,6,0,1v1 Random Map
2277814,Keza,6628,1218,CH,55,30,25,0,1v1 Random Map
1864872,TU VIEJA,6635,1218,AR,101,56,45,4,1v1 Random Map
1790613,Mitya. Acyclical. Cohomology.,6636,1218,US,346,178,168,5,1v1 Random Map
1633111,Kuurenay,6639,1218,ID,16,10,6,0,1v1 Random Map
307225,crooksnm,6641,1218,US,133,68,65,5,1v1 Random Map
2376022,pabloopensthemoon,6672,1217,DE,40,21,19,0,1v1 Random Map
2281770,Lorenzo de' Medici,6673,1217,US,254,135,119,1,1v1 Random Map
1364169,LunaTIC,6678,1217,FI,11,4,7,1,1v1 Random Map
297963,Zook,6679,1217,US,74,40,34,2,1v1 Random Map
1168248,tyfong311,6682,1216,HK,66,36,30,1,1v1 Random Map
735058,TheHiggsMoron,6692,1216,DE,149,79,70,4,1v1 Random Map
1957410,Charles,6705,1216,GB,17,9,8,0,1v1 Random Map
278580,Frysez,6721,1215,NL,110,63,47,0,1v1 Random Map
551949,LizenzEnte50,6734,1215,NA,112,64,48,4,1v1 Random Map
958432,Nicanor,6763,1214,AR,103,56,47,4,1v1 Random Map
701051,MarcoPolo,6767,1214,AT,89,51,38,1,1v1 Random Map
2512886,vladmirchekovsky,6775,1214,US,169,86,83,1,1v1 Random Map
853383,larsgillo1401,6806,1213,AU,237,124,113,9,1v1 Random Map
821635,peaceful,6808,1213,GB,362,183,179,19,1v1 Random Map
3165,afro,6812,1213,US,33,20,13,0,1v1 Random Map
218511,HardNRG,6834,1213,FI,28,20,8,1,1v1 Random Map
1214846,Mawi,6843,1213,SE,173,95,78,5,1v1 Random Map
771501,Pierretto,6849,1212,CH,199,102,97,3,1v1 Random Map
2504250,Showbizz V3sk,6866,1212,BE,13,7,6,1,1v1 Random Map
1871583,miss orange,6873,1212,CN,220,117,103,3,1v1 Random Map
1408147,Taktik,6881,1212,BE,205,106,99,0,1v1 Random Map
825901,Dervish,6886,1211,DE,165,88,77,0,1v1 Random Map
2567249,hesiode,6899,1211,FR,46,27,19,0,1v1 Random Map
278959,namejeff,6920,1210,AU,78,47,31,0,1v1 Random Map
258792,TOAOJCulling,6924,1210,NA,25,13,12,1,1v1 Random Map
1279868,524155638,6951,1210,AR,14,9,5,0,1v1 Random Map
238759,benjamin_esteban,6969,1209,CL,31,16,15,3,1v1 Random Map
2647803,Gozert,6973,1209,NL,26,15,11,0,1v1 Random Map
219280,Phoenix,6987,1209,CN,57,33,24,6,1v1 Random Map
986574,OnlyplayBristle,6997,1208,US,473,243,230,25,1v1 Random Map
469885,Dioblo,7007,1208,BR,636,325,311,19,1v1 Random Map
13280,Mamoo1460,7009,1208,NA,144,78,66,4,1v1 Random Map
362059,Lord Poephaan,7022,1208,BE,63,36,27,0,1v1 Random Map
1978680,Sebalmafuerte,7024,1208,AR,23,15,8,0,1v1 Random Map
1126763,Balol,7043,1207,PL,108,57,51,2,1v1 Random Map
666834,Ximango,7059,1207,BR,10,7,3,1,1v1 Random Map
2596756,SpiDeY_aToR,7069,1207,ES,13,9,4,0,1v1 Random Map
1858170,a69030806903080,7078,1207,TW,30,16,14,0,1v1 Random Map
2642509,zenoN,7105,1206,DE,53,28,25,0,1v1 Random Map
421385,Raynorshine,7137,1205,AU,28,13,15,1,1v1 Random Map
1879875,kaamoss,7152,1205,TR,134,72,62,10,1v1 Random Map
819423,kuartsi,7178,1204,FI,34,19,15,1,1v1 Random Map
1146839,Drunk3n,7211,1203,DE,334,175,159,5,1v1 Random Map
931203,Drulo,7216,1203,AR,11,8,3,0,1v1 Random Map
461393,roger,7226,1203,AR,153,80,73,4,1v1 Random Map
1617039,RemBem,7245,1203,NL,49,27,22,2,1v1 Random Map
521044,Llorminator,7273,1202,ES,160,84,76,2,1v1 Random Map
2040065,johneigner,7287,1202,DE,45,25,20,0,1v1 Random Map
1286478,Vasiliy II,7294,1202,UA,92,49,43,6,1v1 Random Map
888511,ExtRaDaRk_,7301,1201,TR,13,9,4,2,1v1 Random Map
1781378,rapscalyin,7325,1201,US,14,9,5,0,1v1 Random Map
1192481,Whatever,7333,1201,SK,17,11,6,0,1v1 Random Map
669589,Yooo,7344,1200,IN,21,13,8,0,1v1 Random Map
1495037,Elroundyy,7373,1200,DE,65,35,30,1,1v1 Random Map
977385,KARVEN,7383,1199,TR,82,44,38,0,1v1 Random Map
172932,APPA,7406,1199,US,269,140,129,6,1v1 Random Map
1888570,lu.pit,7412,1199,CH,42,22,20,1,1v1 Random Map
814625,TentaGhandi,7427,1198,SE,132,69,63,2,1v1 Random Map
422790,gn02239542,7438,1198,TW,51,27,24,0,1v1 Random Map
82816,Andrexdx,7442,1198,BR,103,55,48,1,1v1 Random Map
2049487,TxLast,7446,1198,FR,130,68,62,3,1v1 Random Map
2327684,Iplk,7484,1197,AU,25,10,15,0,1v1 Random Map
206174,witchblade108,7511,1196,IE,100,55,45,1,1v1 Random Map
2571633,Filip,7526,1196,PL,156,81,75,2,1v1 Random Map
2551620,Siberian Khatru,7527,1196,CO,14,9,5,0,1v1 Random Map
2189484,GoodGuyNat,7531,1196,HN,11,8,3,0,1v1 Random Map
1685064,khanate@nosound,7538,1196,DE,85,45,40,2,1v1 Random Map
316120,Spaceman Spiff,7541,1196,US,11,8,3,0,1v1 Random Map
1526158,RN,7542,1196,AU,107,56,51,0,1v1 Random Map
214757,宇智波一达蜀黍,7553,1195,CN,41,21,20,0,1v1 Random Map
510506,Ger2107,7564,1195,ES,441,228,213,7,1v1 Random Map
1953008,KinG WaSSeRaHNo,7577,1195,FR,39,24,15,0,1v1 Random Map
341187,theworriestkill,7578,1195,DE,113,61,52,0,1v1 Random Map
1353415,Yoda17,7591,1195,FR,187,102,85,5,1v1 Random Map
865016,BillaBamZilla,7600,1194,AE,58,33,25,2,1v1 Random Map
686866,Orla,7607,1194,HR,88,48,40,8,1v1 Random Map
501606,Cello,7611,1194,FR,269,139,130,3,1v1 Random Map
2657214,Ioannis_Hood,7616,1194,MX,29,16,13,0,1v1 Random Map
2435090,oulouvator,7618,1194,FR,26,15,11,0,1v1 Random Map
1904881,thehawkman,7625,1194,US,57,34,23,1,1v1 Random Map
277627,Noobao,7642,1193,IE,232,123,109,2,1v1 Random Map
1991202,NCO,7663,1193,FR,194,103,91,3,1v1 Random Map
1970348,TuRCO_MAu,7664,1193,BR,20,12,8,0,1v1 Random Map
302570,Arafat,7667,1193,AR,467,233,234,3,1v1 Random Map
32257,teban0721,7697,1192,JP,468,243,225,4,1v1 Random Map
1406543,這不是身分證b123340886,7706,1192,AR,332,170,162,3,1v1 Random Map
658899,matt_Solo,7721,1191,HK,13,9,4,0,1v1 Random Map
211259,HTML,7723,1191,HK,36,20,16,0,1v1 Random Map
2181026,gilroy204,7741,1191,GB,37,21,16,0,1v1 Random Map
1712988,thomas.frith,7750,1191,GB,189,96,93,7,1v1 Random Map
1000735,Angst Potter,7762,1190,DE,120,62,58,2,1v1 Random Map
512949,Cajita Feliz,7773,1190,CL,59,31,28,0,1v1 Random Map
2763019,Ivan,7776,1190,PE,25,14,11,0,1v1 Random Map
276948,swigers,7797,1189,CH,131,71,60,2,1v1 Random Map
547189,rhapsody,7805,1189,TR,29,13,16,0,1v1 Random Map
1862026,584860439,7821,1189,CN,353,181,172,11,1v1 Random Map
1812818,Mush,7823,1189,HU,15,10,5,0,1v1 Random Map
280809,Tired,7835,1188,IT,24,14,10,1,1v1 Random Map
489524,YasuoOP,7843,1188,NL,17,11,6,0,1v1 Random Map
229702,xxEGCxx,7845,1188,MX,31,17,14,4,1v1 Random Map
2449230,Sinful,7851,1188,CA,11,8,3,0,1v1 Random Map
314433,Minjammben,7866,1188,US,17,11,6,0,1v1 Random Map
287739,Hell Topo,7872,1188,FR,44,24,20,0,1v1 Random Map
509383,Stewie,7884,1187,DE,10,6,4,0,1v1 Random Map
406582,Oonga Boonga,7889,1187,CL,37,21,16,1,1v1 Random Map
2343540,啊浩,7893,1187,CN,77,46,31,2,1v1 Random Map
1919556,Héos,7897,1187,FR,66,37,29,2,1v1 Random Map
1536575,Fleischwolf,7910,1187,DE,16,10,6,0,1v1 Random Map
1444824,Vlarham,7912,1187,FR,59,33,26,0,1v1 Random Map
2723392,Lord_calderon,7936,1186,AR,47,26,21,0,1v1 Random Map
224792,Corona_bayruZ,7941,1186,MX,62,36,26,2,1v1 Random Map
2171921,Schmuddlomi,7944,1186,DE,49,30,19,8,1v1 Random Map
143647,Zoso,7978,1185,TH,217,112,105,3,1v1 Random Map
2433516,wang_noob,7989,1185,GB,43,25,18,0,1v1 Random Map
1812087,selordsimo,8003,1185,DE,181,95,86,1,1v1 Random Map
1808121,Negrev,8004,1185,AR,223,120,103,4,1v1 Random Map
1144573,jcmoney,8012,1184,US,227,117,110,2,1v1 Random Map
241906,Lord Morest,8029,1184,CO,14,8,6,0,1v1 Random Map
1805906,urki,8056,1184,SI,33,17,16,3,1v1 Random Map
1770697,chino1339,8058,1184,ES,48,27,21,0,1v1 Random Map
537386,Chicken Thuggets,8081,1183,AU,22,13,9,1,1v1 Random Map
1021599,voblivion,8105,1182,CA,21,7,14,1,1v1 Random Map
213949,6 TC Boom,8107,1182,GB,77,43,34,1,1v1 Random Map
249767,Robin0404,8118,1182,DE,12,8,4,1,1v1 Random Map
1495665,DEUS VULT,8142,1182,GB,151,81,70,0,1v1 Random Map
2062797,noobyonee,8172,1181,NA,371,188,183,3,1v1 Random Map
840293,Camvais,8188,1180,FI,90,48,42,1,1v1 Random Map
793244,yonathan,8189,1180,DE,54,31,23,1,1v1 Random Map
1835087,Azwei,8216,1180,FR,166,88,78,0,1v1 Random Map
1410192,TowerRusher,8226,1180,KZ,315,157,158,36,1v1 Random Map
1144086,Mikonos,8231,1179,AU,419,215,204,3,1v1 Random Map
209449,Norik,8247,1179,GB,46,24,22,1,1v1 Random Map
2483687,EasyGame,8250,1179,HK,32,9,23,0,1v1 Random Map
2397822,Pallamoto,8255,1179,TR,24,15,9,2,1v1 Random Map
1810972,Baumewok,8260,1179,DE,78,42,36,0,1v1 Random Map
283465,Shakuni,8269,1178,US,16,11,5,0,1v1 Random Map
2062279,serei,8293,1178,DE,288,147,141,11,1v1 Random Map
1465183,Jeanne d' Arc,8308,1178,AR,103,57,46,1,1v1 Random Map
300705,Darth_Nox,8311,1178,US,12,8,4,4,1v1 Random Map
1073158,Juda_the_rabbi,8320,1177,DE,94,47,47,0,1v1 Random Map
66197,Zac Power Moon Rider,8341,1177,AU,27,16,11,0,1v1 Random Map
2462300,RaveN,8343,1177,ES,24,15,9,0,1v1 Random Map
2051708,Schiggy,8348,1177,CA,11,0,11,1,1v1 Random Map
574356,Latrineking,8372,1176,AU,21,13,8,1,1v1 Random Map
422856,holymackerel,8379,1176,GB,644,328,316,2,1v1 Random Map
2111072,THOR,8386,1176,BR,12,8,4,0,1v1 Random Map
170400,Nightman,8399,1176,US,19,11,8,1,1v1 Random Map
555301,Ostertag_00,8416,1175,US,94,49,45,2,1v1 Random Map
2531022,Yafes,8422,1175,TR,33,17,16,1,1v1 Random Map
1675954,Nikrendo,8440,1175,NA,105,53,52,4,1v1 Random Map
1166294,Fobin,8446,1174,DE,82,44,38,0,1v1 Random Map
2282450,iKon Gaming TV ✞,8474,1174,GB,14,9,5,0,1v1 Random Map
1567270,ThingsILack,8486,1174,US,128,69,59,3,1v1 Random Map
1129802,EagleCCC,8490,1173,TW,170,86,84,1,1v1 Random Map
1065975,Duldran,8491,1173,DE,21,13,8,0,1v1 Random Map
264470,Joako =),8496,1173,CL,71,41,30,7,1v1 Random Map
2049861,Hellscream,8526,1173,CN,51,30,21,0,1v1 Random Map
2059851,Skull,8576,1172,FR,475,242,233,1,1v1 Random Map
95369,RIBBEN,8593,1171,BE,39,22,17,2,1v1 Random Map
1013995,Babifort,8595,1171,FR,211,110,101,3,1v1 Random Map
239329,Nagaraj226,8600,1171,IN,245,125,120,9,1v1 Random Map
1954837,PA,8623,1171,FR,197,103,94,10,1v1 Random Map
1784304,Argoon,8626,1171,FI,76,40,36,0,1v1 Random Map
212965,dnh,8637,1170,JP,26,15,11,0,1v1 Random Map
210551,LitvinovII,8645,1170,MX,145,78,67,3,1v1 Random Map
2494148,rautnn,8653,1170,TW,33,18,15,0,1v1 Random Map
1465263,biliblil丶枭,8669,1170,CN,25,17,8,1,1v1 Random Map
304228,Cuba,8670,1170,AR,36,21,15,0,1v1 Random Map
1287546,Jewst,8672,1170,US,13,6,7,0,1v1 Random Map
892634,AutoKarL,8680,1169,CL,21,4,17,0,1v1 Random Map
441227,Korean BBQ,8691,1169,AR,464,241,223,8,1v1 Random Map
1005646,zh.sledge,8725,1168,CA,54,29,25,1,1v1 Random Map
224474,deev,8751,1168,US,199,106,93,3,1v1 Random Map
2063863,Gothic_lonely_skull,8758,1168,CH,10,7,3,0,1v1 Random Map
1493610,Dr Loom,8769,1168,US,78,42,36,0,1v1 Random Map
688301,Bevoishot,8790,1167,AU,38,20,18,3,1v1 Random Map
2477619,Chuck Norris,8800,1167,RO,12,5,7,0,1v1 Random Map
1920975,Botzanga,8811,1167,MX,73,38,35,2,1v1 Random Map
266995,Mr. Dziks,8830,1166,PL,52,29,23,1,1v1 Random Map
824236,Sylo,8874,1165,BG,33,19,14,1,1v1 Random Map
2512314,ScarfacePR,8892,1165,BR,52,28,24,0,1v1 Random Map
1840674,Adiosomg,8908,1165,NA,84,48,36,1,1v1 Random Map
1604452,LNSA,8913,1165,AR,47,25,22,0,1v1 Random Map
302128,TheShawThing,8918,1165,AU,10,5,5,0,1v1 Random Map
1960004,Dgorcia,8949,1164,MX,38,19,19,0,1v1 Random Map
1354571,GoodBeer,8962,1164,FR,51,29,22,0,1v1 Random Map
842087,Shellrock,8973,1163,CH,177,91,86,2,1v1 Random Map
1204131,AlyenOne,9006,1163,NA,280,150,130,7,1v1 Random Map
662937,Sterling,9020,1162,IT,13,6,7,0,1v1 Random Map
2361876,nailien,9032,1162,GB,24,14,10,0,1v1 Random Map
2237954,Wiful,9035,1162,AR,10,4,6,0,1v1 Random Map
334497,Dom,9040,1162,NL,110,58,52,0,1v1 Random Map
1112400,AngelFaust,9050,1161,US,13,8,5,0,1v1 Random Map
1005258,Gwiel,9051,1161,DE,81,44,37,1,1v1 Random Map
480954,cachiporokas,9060,1161,MX,266,134,132,8,1v1 Random Map
471756,Capitalist Dog,9061,1161,US,57,32,25,0,1v1 Random Map
267420,Bobby Stoker,9098,1160,US,249,128,121,7,1v1 Random Map
2507545,0010001010,9118,1160,CL,57,30,27,0,1v1 Random Map
2348228,luk,9126,1160,DE,53,29,24,4,1v1 Random Map
1211615,Ridash,9153,1160,SE,110,59,51,0,1v1 Random Map
266653,GWC_Roadrunner,9159,1159,DE,80,44,36,0,1v1 Random Map
2118427,supersuperslu,9190,1159,GB,97,48,49,0,1v1 Random Map
211284,Snweos,9215,1158,AU,10,7,3,0,1v1 Random Map
496862,django91x,9223,1158,QA,22,13,9,0,1v1 Random Map
232707,Citifiedjungle,9225,1158,NO,241,125,116,13,1v1 Random Map
2472047,RBG,9234,1158,BG,25,15,10,0,1v1 Random Map
2251715,sampsadios,9244,1158,FI,33,20,13,0,1v1 Random Map
207721,BadMaru,9252,1158,BR,106,57,49,2,1v1 Random Map
297533,4rk.V0n,9262,1158,CN,42,26,16,0,1v1 Random Map
1298037,Stezen9096,9263,1158,NA,166,90,76,0,1v1 Random Map
1192725,Heos,9266,1158,FR,91,50,41,9,1v1 Random Map
261278,All Reilled Up,9275,1157,GB,28,16,12,0,1v1 Random Map
258220,derri,9277,1157,ES,10,4,6,0,1v1 Random Map
224065,Spinksy,9297,1157,GB,52,30,22,1,1v1 Random Map
1553006,Bahazhor,9311,1157,BR,19,11,8,2,1v1 Random Map
547102,tzengo,9332,1156,DE,134,69,65,1,1v1 Random Map
1051156,Elman Quito,9360,1155,ES,256,130,126,10,1v1 Random Map
894839,Feathers McGraw,9367,1155,AU,43,24,19,0,1v1 Random Map
860293,AOE_Arnaud,9369,1155,FR,630,322,308,2,1v1 Random Map
395726,guntram,9387,1155,CH,79,44,35,0,1v1 Random Map
285283,BOBACHICKEN,9412,1154,DE,26,15,11,0,1v1 Random Map
463774,Massito8,9429,1154,UY,167,88,79,8,1v1 Random Map
2339667,danz,9443,1154,CA,53,28,25,0,1v1 Random Map
2123150,cynenenenene,9445,1154,CN,91,49,42,12,1v1 Random Map
1938216,JakeyBoy,9448,1154,GB,76,43,33,3,1v1 Random Map
1565272,Trumpitrampeltier,9459,1154,AT,54,28,26,1,1v1 Random Map
1221240,Prometheus,9468,1154,AU,41,22,19,1,1v1 Random Map
787853,grzegor2005,9475,1153,GB,162,84,78,6,1v1 Random Map
1938411,Apostate,9497,1153,SI,38,19,19,2,1v1 Random Map
278844,BlancuZ,9517,1152,CR,26,15,11,0,1v1 Random Map
46729,EnquiringStone,9518,1152,NA,13,5,8,0,1v1 Random Map
580425,Oranje,9531,1152,DE,30,15,15,0,1v1 Random Map
2231459,miko0,9547,1152,PL,149,75,74,1,1v1 Random Map
1991092,Unum7,9552,1152,ES,19,8,11,0,1v1 Random Map
1493917,IronDragon,9563,1152,DE,32,21,11,0,1v1 Random Map
817575,Æurosswydd,9572,1151,TR,180,96,84,11,1v1 Random Map
239649,Rã,9577,1151,TR,10,3,7,3,1v1 Random Map
1151161,JaegerMan,9612,1151,US,105,57,48,3,1v1 Random Map
1077418,agustinlopezz95,9615,1150,AR,76,39,37,0,1v1 Random Map
271534,Asher da KK,9619,1150,US,93,48,45,1,1v1 Random Map
924441,PK,9622,1150,BR,40,23,17,0,1v1 Random Map
246540,Keukenschaar,9629,1150,BE,41,22,19,0,1v1 Random Map
594754,Captain_Jacky,9630,1150,IN,677,343,334,29,1v1 Random Map
2574968,= =a,9639,1150,AR,19,9,10,0,1v1 Random Map
1834215,PraZZenD,9660,1150,NL,12,7,5,0,1v1 Random Map
1489216,T,9665,1150,TW,20,11,9,0,1v1 Random Map
896853,marskit09261,9681,1149,HK,19,11,8,0,1v1 Random Map
257469,lordzaamus,9683,1149,IT,295,152,143,6,1v1 Random Map
2128846,Yapzehemnem,9699,1149,CA,13,8,5,0,1v1 Random Map
1404067,Kyrios,9718,1149,DE,246,127,119,3,1v1 Random Map
273840,Ganicus92,9726,1148,ES,119,63,56,4,1v1 Random Map
297700,Joan1796,9770,1148,MX,264,136,128,6,1v1 Random Map
1051343,mezdap,9778,1147,TR,16,9,7,0,1v1 Random Map
590036,Kesakoo,9792,1147,VN,315,159,156,7,1v1 Random Map
565778,Mind Mirror,9799,1147,AU,40,22,18,0,1v1 Random Map
69273,G-shock,9805,1147,TW,96,52,44,0,1v1 Random Map
395245,Guillote,9809,1147,AR,27,14,13,2,1v1 Random Map
2372863,mtrx_ upgrade.gg,9811,1147,BR,14,8,6,0,1v1 Random Map
2158296,huawa,9813,1147,AT,18,11,7,0,1v1 Random Map
1487542,QuốcThịnh,9830,1147,VN,145,77,68,6,1v1 Random Map
1192801,nugibaba,9836,1147,TR,83,44,39,5,1v1 Random Map
721771,Diheadwarlord,9851,1146,US,111,59,52,0,1v1 Random Map
236750,Purkrabi,9861,1146,SK,154,84,70,15,1v1 Random Map
1915149,Pepeje SapéKomJamais,9882,1146,FR,161,87,74,0,1v1 Random Map
1716736,Papinien,9889,1146,FR,55,31,24,0,1v1 Random Map
772327,wurst456,9902,1145,AT,17,11,6,0,1v1 Random Map
593900,Flying Weasel,9906,1145,AU,94,54,40,3,1v1 Random Map
1285622,Just Passing,9945,1145,RU,61,35,26,0,1v1 Random Map
276422,Manifold,9953,1144,AR,80,42,38,2,1v1 Random Map
274309,Trench Dog,9955,1144,CA,42,23,19,0,1v1 Random Map
837131,zukarii-,9958,1144,NL,33,18,15,0,1v1 Random Map
491712,Atlas,9969,1144,DK,50,29,21,1,1v1 Random Map
439064,CPC43,9973,1144,TW,34,18,16,0,1v1 Random Map
225359,Shiro,9981,1144,CL,57,31,26,0,1v1 Random Map
222938,Metalicox,9988,1144,CL,87,44,43,0,1v1 Random Map
14400,Luffy,10001,1144,IN,51,28,23,3,1v1 Random Map
705142,noetic le_guerier,10024,1143,CH,20,13,7,0,1v1 Random Map
665204,Voxxeron,10027,1143,NA,18,11,7,0,1v1 Random Map
424044,IncaHootsWithMahouts,10034,1143,GB,23,14,9,0,1v1 Random Map
268466,At0mflunder,10064,1142,DE,23,12,11,0,1v1 Random Map
367874,IvanovichCS,10088,1142,NA,312,191,121,23,1v1 Random Map
1216146,TJ,10105,1142,US,264,136,128,2,1v1 Random Map
901674,deebsy,10108,1141,GB,81,43,38,2,1v1 Random Map
246185,FrankTheTank,10111,1141,DE,337,175,162,3,1v1 Random Map
2663328,God Hand K,10120,1141,HK,78,40,38,1,1v1 Random Map
1881874,El Libertador,10140,1141,AR,60,33,27,1,1v1 Random Map
1840957,Panaxios,10143,1141,GR,28,16,12,1,1v1 Random Map
891069,but jit is alone,10165,1140,TR,335,169,166,19,1v1 Random Map
788724,dawoagepl,10168,1140,PL,229,117,112,14,1v1 Random Map
626229,† WALLACE †,10176,1140,TR,100,52,48,1,1v1 Random Map
2131348,ckdcck5160,10185,1140,TW,11,7,4,1,1v1 Random Map
318687,Zemaitis32,10199,1140,US,88,48,40,0,1v1 Random Map
1198763,Cloudy the Grey Bunny,10211,1140,AU,26,15,11,0,1v1 Random Map
799448,Jose de Urquiza,10222,1139,AR,102,50,52,6,1v1 Random Map
2624307,Jahikoi,10239,1139,AU,36,20,16,0,1v1 Random Map
2049173,Rumtreiber,10254,1139,DE,106,53,53,1,1v1 Random Map
1812599,nhljunkie68,10257,1139,NA,191,97,94,2,1v1 Random Map
473207,Quelfalas,10285,1138,TR,284,146,138,6,1v1 Random Map
2482898,Abyss,10291,1138,ES,10,3,7,0,1v1 Random Map
2127029,Devil.QuangBinh,10302,1138,VN,31,17,14,0,1v1 Random Map
2000544,T2TL,10303,1138,DK,14,9,5,0,1v1 Random Map
1972419,hercko,10306,1138,ES,63,33,30,1,1v1 Random Map
1559605,Song,10315,1138,CN,79,44,35,2,1v1 Random Map
1076310,holgh,10321,1137,DE,16,10,6,1,1v1 Random Map
841799,Elessar,10328,1137,FR,103,55,48,3,1v1 Random Map
1314588,Fjalknwulf,10366,1137,DE,56,30,26,0,1v1 Random Map
902035,Baxa,10374,1136,HU,468,241,227,12,1v1 Random Map
767731,Tavik,10385,1136,CZ,22,11,11,0,1v1 Random Map
2005413,colonel_andrews,10407,1136,US,124,66,58,4,1v1 Random Map
1029543,moskon95,10428,1135,AT,87,45,42,3,1v1 Random Map
188855,Boengar,10450,1135,AT,25,12,13,0,1v1 Random Map
1594806,Vazilin,10470,1135,DE,268,140,128,3,1v1 Random Map
786760,Bantikos,10485,1134,FR,13,8,5,0,1v1 Random Map
606780,TestosteroneRAGE,10492,1134,CA,20,12,8,1,1v1 Random Map
1467421,Chapapote,10520,1134,ES,232,122,110,13,1v1 Random Map
298849,WeaselAccordion,10523,1134,US,100,58,42,1,1v1 Random Map
1165493,koido,10530,1133,FR,11,7,4,0,1v1 Random Map
269193,Jonny Quest,10538,1133,US,51,29,22,2,1v1 Random Map
575568,Krushlix,10547,1133,CH,17,10,7,0,1v1 Random Map
2655893,Millsoir,10553,1133,US,38,17,21,0,1v1 Random Map
302612,Thanatos,10572,1133,US,62,31,31,1,1v1 Random Map
521325,Sabaduqui,10592,1132,AR,174,89,85,4,1v1 Random Map
2010952,Artu959,10611,1132,IT,10,7,3,1,1v1 Random Map
1904304,obmar31,10617,1132,TW,14,7,7,0,1v1 Random Map
269034,Eddoe,10646,1131,NL,203,103,100,2,1v1 Random Map
1784863,OO KING,10675,1131,GR,144,77,67,2,1v1 Random Map
224726,Tyb,10722,1130,DE,203,102,101,2,1v1 Random Map
669375,jillmji,10761,1129,CN,459,233,226,7,1v1 Random Map
521498,tfair7850,10767,1129,US,146,78,68,6,1v1 Random Map
2397575,Splinked,10778,1129,GB,277,145,132,9,1v1 Random Map
224368,HassLiebe,10779,1129,DE,10,7,3,0,1v1 Random Map
1927435,sapa578,10785,1129,JP,311,160,151,0,1v1 Random Map
219889,Vanessa,10791,1129,CH,39,22,17,1,1v1 Random Map
1721120,TomasRu,10794,1129,AR,54,27,27,11,1v1 Random Map
1717062,Avesonn,10795,1129,NA,25,14,11,0,1v1 Random Map
1534447,Natsu,10797,1129,PL,169,88,81,0,1v1 Random Map
1074112,indochine8,10811,1128,FR,62,35,27,0,1v1 Random Map
275547,SONICneedsRINGS,10814,1128,NA,34,20,14,1,1v1 Random Map
2633482,Linqard,10839,1128,GB,11,7,4,0,1v1 Random Map
2472683,kirby_13,10842,1128,FR,23,14,9,2,1v1 Random Map
2403496,Whiskey517,10844,1128,US,11,7,4,1,1v1 Random Map
2157170,sml,10847,1128,US,40,19,21,0,1v1 Random Map
217870,PREDATOR,10862,1128,FR,38,23,15,0,1v1 Random Map
1075114,Tony O,10869,1127,FR,238,123,115,1,1v1 Random Map
212645,fencer1509,10873,1127,DE,156,81,75,2,1v1 Random Map
554802,kokomuti,10880,1127,GB,165,86,79,16,1v1 Random Map
2353047,Raizen,10896,1127,CL,37,17,20,1,1v1 Random Map
230986,Traviskbach,10941,1126,US,28,14,14,0,1v1 Random Map
2537882,KsHulO,10946,1126,CL,13,6,7,0,1v1 Random Map
351679,MontyBurns_GP,10958,1126,DE,166,86,80,1,1v1 Random Map
216652,Lachie,10967,1126,AU,14,8,6,0,1v1 Random Map
213097,uft.jack,10977,1125,IQ,102,53,49,24,1v1 Random Map
413444,kaepora_gaebora,10991,1125,AU,33,19,14,0,1v1 Random Map
1911101,allyourbrainz,11015,1125,TR,20,12,8,0,1v1 Random Map
289340,Le Quack,11025,1125,CL,62,32,30,3,1v1 Random Map
277556,NERD,11033,1124,US,51,26,25,0,1v1 Random Map
941979,Lewl,11036,1124,CA,81,45,36,1,1v1 Random Map
744586,mestariteos,11042,1124,FI,44,25,19,0,1v1 Random Map
688886,thibault.gpil,11044,1124,FR,11,7,4,0,1v1 Random Map
654290,Rampager,11046,1124,AU,46,27,19,3,1v1 Random Map
622735,WeirdoBeaver,11049,1124,SE,20,11,9,0,1v1 Random Map
613521,redbones,11051,1124,CA,527,262,265,7,1v1 Random Map
209885,Guardian Azul,11054,1124,MX,587,299,288,11,1v1 Random Map
2547071,_Cactus_,11058,1124,BR,192,99,93,2,1v1 Random Map
2202588,yenky,11067,1124,DK,152,83,69,11,1v1 Random Map
2089111,kevs_234,11070,1124,AR,55,29,26,0,1v1 Random Map
1931981,Polo1213,11076,1124,FR,11,7,4,1,1v1 Random Map
299980,The Wolf King,11085,1124,US,44,25,19,2,1v1 Random Map
2333411,Prot4gonist,11121,1123,DE,28,15,13,0,1v1 Random Map
992425,Wai,11144,1122,HK,84,45,39,5,1v1 Random Map
210591,Link,11162,1122,DE,85,45,40,3,1v1 Random Map
2676923,cuAto,11165,1122,CO,68,35,33,1,1v1 Random Map
2475919,Budweiser,11167,1122,AR,49,28,21,0,1v1 Random Map
2300492,芽芽皮皮,11171,1122,CN,226,114,112,8,1v1 Random Map
2253922,Fuzuli,11174,1122,TR,36,21,15,0,1v1 Random Map
365245,Rain McVarelk,11178,1122,FR,39,21,18,2,1v1 Random Map
2128393,P♠LTERSH♠T,11182,1122,LU,36,21,15,0,1v1 Random Map
1433930,TornnnN,11194,1122,FR,357,183,174,9,1v1 Random Map
240176,Bierzantiner,11212,1121,DE,108,54,54,1,1v1 Random Map
1658628,aDr-,11244,1121,FR,61,35,26,0,1v1 Random Map
249544,York Le Bourrin,11268,1120,FR,15,9,6,0,1v1 Random Map
610102,Answaldomir,11271,1120,AT,10,7,3,0,1v1 Random Map
2697803,Vader_Prime,11276,1120,IN,13,8,5,1,1v1 Random Map
2477846,Sw3aty LOL,11283,1120,GR,22,12,10,0,1v1 Random Map
1186494,Raptoriwori,11311,1120,NL,29,10,19,0,1v1 Random Map
718451,| JNP |,11323,1119,DE,70,39,31,0,1v1 Random Map
473378,Kaltenburg,11332,1119,DE,806,408,398,16,1v1 Random Map
884170,birdperson,11395,1118,DE,292,148,144,6,1v1 Random Map
2435553,Meerenn,11420,1118,FR,41,19,22,0,1v1 Random Map
221593,Leter Pustig,11431,1118,DE,75,40,35,0,1v1 Random Map
1978419,Itani,11432,1118,BR,43,19,24,2,1v1 Random Map
1837217,simondoof,11436,1118,DE,32,18,14,0,1v1 Random Map
1655383,Pat6923,11441,1118,NA,12,7,5,0,1v1 Random Map
251299,Pas,11466,1117,GB,13,8,5,1,1v1 Random Map
660213,Lohabquas,11468,1117,HR,329,67,262,1,1v1 Random Map
405725,Niczer,11474,1117,CL,77,42,35,2,1v1 Random Map
2319777,ReloaDreamS,11485,1117,CO,34,17,17,1,1v1 Random Map
1602656,pauledouardo,11507,1117,FR,46,24,22,1,1v1 Random Map
1127854,Tinuu,11514,1116,CH,49,31,18,1,1v1 Random Map
235242,Szymski,11533,1116,PL,17,10,7,1,1v1 Random Map
445560,Bastianvdkerkhoff,11537,1116,NL,59,31,28,0,1v1 Random Map
405297,Roland Ferrier,11540,1116,US,15,9,6,0,1v1 Random Map
2064286,veganemayonnaise,11550,1116,DE,44,26,18,1,1v1 Random Map
333016,[Supersweet1600]Hexenkoenig,11557,1116,DE,16,8,8,0,1v1 Random Map
518152,YISITHEGR8,11591,1115,GB,15,9,6,0,1v1 Random Map
220754,UnitedTFT,11616,1115,DE,370,189,181,10,1v1 Random Map
115170,Garc99,11628,1115,US,173,91,82,16,1v1 Random Map
1086258,Teiiko,11632,1114,FR,345,176,169,7,1v1 Random Map
955437,Jerry Lee,11633,1114,CZ,41,21,20,1,1v1 Random Map
2526098,xpiAx,11654,1114,TR,36,18,18,2,1v1 Random Map
386701,Schlagmett,11659,1114,DE,47,26,21,0,1v1 Random Map
2168571,KapEr,11669,1114,SK,75,38,37,3,1v1 Random Map
348530,Talisker,11671,1114,NL,66,34,32,1,1v1 Random Map
1663113,Immartal,11680,1114,NL,59,30,29,1,1v1 Random Map
1383788,paulovmcm,11686,1114,BR,114,51,63,41,1v1 Random Map
1361410,藍受a相赫,11688,1114,TW,28,15,13,1,1v1 Random Map
251624,Tekooo,11703,1113,TR,215,113,102,3,1v1 Random Map
528556,1522948489,11709,1113,CN,45,24,21,5,1v1 Random Map
428665,sack,11716,1113,NZ,144,75,69,10,1v1 Random Map
1798437,Jenes Bookwood,11738,1113,DE,13,8,5,1,1v1 Random Map
1326158,sebfs38,11749,1113,FR,19,11,8,0,1v1 Random Map
270669,Franzeppo,11757,1112,AR,11,7,4,0,1v1 Random Map
260043,grund-wascht,11760,1112,DE,335,171,164,5,1v1 Random Map
249978,AbrahamXY,11764,1112,JO,101,55,46,0,1v1 Random Map
2273408,Pker,11782,1112,CA,68,34,34,0,1v1 Random Map
2018599,El_churrete,11784,1112,AR,56,32,24,1,1v1 Random Map
435969,Sp00Ky,11830,1111,DE,11,5,6,1,1v1 Random Map
427334,BBF3,11831,1111,DE,172,88,84,0,1v1 Random Map
2324026,Coops90,11838,1111,GB,38,20,18,0,1v1 Random Map
317424,MaN0L0Mx,11860,1111,MX,20,11,9,0,1v1 Random Map
749765,wouter,11886,1110,NL,126,66,60,6,1v1 Random Map
2642833,tomishibachti,11899,1110,BE,43,23,20,0,1v1 Random Map
2014613,LRI-ItalicFalic,11914,1110,AR,12,7,5,2,1v1 Random Map
1919852,Lenno,11917,1110,DE,22,12,10,1,1v1 Random Map
1437310,konstantin,11925,1110,DK,54,28,26,0,1v1 Random Map
939546,gilchivas,11936,1109,MX,39,20,19,0,1v1 Random Map
930223,ferret99,11937,1109,US,125,64,61,1,1v1 Random Map
622840,takedown66,11951,1109,US,124,66,58,1,1v1 Random Map
2445114,RocketCat,11964,1109,IS,38,22,16,1,1v1 Random Map
2290156,CapThor95,11969,1109,AR,46,21,25,3,1v1 Random Map
2105675,Lampiao,11977,1109,BR,265,135,130,4,1v1 Random Map
1687878,QuietProfesional,11986,1109,AU,120,64,56,1,1v1 Random Map
1467023,edricsturm,11990,1109,DE,143,78,65,1,1v1 Random Map
717825,Considéré en tant que tel,12011,1108,FR,13,7,6,0,1v1 Random Map
241647,Mibis,12016,1108,TR,484,247,237,18,1v1 Random Map
373585,Smoke Monkey,12028,1108,CZ,32,15,17,0,1v1 Random Map
1374629,slavijo,12052,1108,US,21,12,9,1,1v1 Random Map
287365,Jaero(Modo peso muerto),12061,1108,AR,34,17,17,0,1v1 Random Map
2156415,KabukiBoy9671,12100,1107,NA,15,9,6,0,1v1 Random Map
2127698,Pepe Kakemann,12103,1107,DE,81,43,38,0,1v1 Random Map
2120091,Maus,12104,1107,CL,13,6,7,0,1v1 Random Map
2070396,generic47,12105,1107,NA,202,105,97,0,1v1 Random Map
469666,BarefootCoast66,12147,1106,NA,15,8,7,0,1v1 Random Map
455597,Victor751,12149,1106,US,86,44,42,0,1v1 Random Map
439207,Baato,12150,1106,SI,16,10,6,0,1v1 Random Map
323247,allen121415,12173,1106,TW,28,16,12,0,1v1 Random Map
1181516,carl_burt,12185,1105,AU,345,176,169,2,1v1 Random Map
1206757,Lazrick,12240,1105,CA,26,15,11,0,1v1 Random Map
810388,Brasidas,12256,1104,FR,93,47,46,1,1v1 Random Map
535399,Krylir,12268,1104,PL,31,13,18,3,1v1 Random Map
1901343,TangoZoulou,12293,1104,CH,14,8,6,0,1v1 Random Map
1499514,skintel,12300,1104,DE,22,13,9,0,1v1 Random Map
1252576,knightman,12305,1104,AU,130,67,63,0,1v1 Random Map
835394,Wololo,12316,1103,US,138,70,68,4,1v1 Random Map
516899,Nigho,12327,1103,RO,59,31,28,2,1v1 Random Map
2509955,Crimat,12334,1103,CA,338,174,164,4,1v1 Random Map
2423689,jeridas,12337,1103,DE,10,6,4,0,1v1 Random Map
224251,RenanMS,12338,1103,CA,72,36,36,1,1v1 Random Map
2075686,tiddies,12343,1103,AU,29,14,15,0,1v1 Random Map
1944686,edaba,12350,1103,AR,27,14,13,0,1v1 Random Map
1899786,johnny23467,12353,1103,TW,13,8,5,1,1v1 Random Map
1187099,maemze,12365,1103,CH,15,9,6,0,1v1 Random Map
254475,OmegaRyZ,12373,1102,FR,36,23,13,0,1v1 Random Map
536967,NoMad,12383,1102,BG,26,14,12,1,1v1 Random Map
2388529,klad,12397,1102,GB,55,28,27,0,1v1 Random Map
2372084,Stebz13,12398,1102,US,74,38,36,1,1v1 Random Map
2129228,123abcd321,12406,1102,DE,334,171,163,1,1v1 Random Map
2183562,Ing Electrico,12468,1101,CL,88,50,38,2,1v1 Random Map
1981742,Fin1887,12479,1101,DE,39,22,17,2,1v1 Random Map
219991,Korez,12486,1101,FI,354,179,175,19,1v1 Random Map
314915,Kasara,12491,1101,US,101,54,47,1,1v1 Random Map
1172553,WololoWitek,12496,1100,PL,74,40,34,2,1v1 Random Map
985628,frailix,12501,1100,DE,40,18,22,4,1v1 Random Map
251654,QiPepXi,12509,1100,CL,39,21,18,1,1v1 Random Map
2364775,El Pirules,12528,1100,US,17,9,8,1,1v1 Random Map
2232751,Bread Pitt,12529,1100,IT,22,11,11,0,1v1 Random Map
1680714,rwj0003,12541,1100,US,122,63,59,4,1v1 Random Map
839494,Gladius,12560,1099,RU,165,88,77,6,1v1 Random Map
1600111,feticalol,12601,1099,BE,12,6,6,0,1v1 Random Map
1150058,GGkhan,12613,1098,DE,440,224,216,12,1v1 Random Map
1022916,Frolicols,12620,1098,GB,41,19,22,1,1v1 Random Map
889371,JHLKing,12625,1098,DE,90,47,43,4,1v1 Random Map
327944,Apfelschorly,12675,1098,DE,11,5,6,0,1v1 Random Map
1424831,prayr,12681,1098,UY,12,3,9,0,1v1 Random Map
273354,Doppelganger,12689,1097,CL,41,22,19,0,1v1 Random Map
858703,Erilium,12693,1097,TR,54,28,26,0,1v1 Random Map
2680626,TrollingHard,12713,1097,US,16,8,8,0,1v1 Random Map
2272397,Whoops,12723,1097,AU,19,10,9,0,1v1 Random Map
2101157,CovidBryant,12726,1097,ES,52,29,23,0,1v1 Random Map
1566804,DrKingKow,12738,1097,CA,89,47,42,1,1v1 Random Map
1417825,Bojack,12741,1097,DE,45,24,21,3,1v1 Random Map
684278,抹茶巧克力,12765,1096,US,13,8,5,0,1v1 Random Map
511797,3dot,12768,1096,CH,209,108,101,1,1v1 Random Map
2633608,JeyAy,12775,1096,DE,11,5,6,0,1v1 Random Map
2102751,El Quino!,12785,1096,FR,86,47,39,1,1v1 Random Map
1211723,Sho Ya,12808,1096,CA,10,1,9,0,1v1 Random Map
1087509,Mariah Carry,12811,1095,BG,88,47,41,4,1v1 Random Map
41316,mkzane,12825,1095,US,111,57,54,2,1v1 Random Map
304795,Dean Sean Bean,12867,1095,AU,58,31,27,1,1v1 Random Map
1314609,Ender,12870,1095,FR,16,9,7,0,1v1 Random Map
734621,melixc77,12880,1094,CL,40,23,17,1,1v1 Random Map
676532,TBK | Stig_Bubblecard,12883,1094,GB,253,130,123,10,1v1 Random Map
225998,Zocker117494,12900,1094,DE,27,14,13,0,1v1 Random Map
2534112,Fran,12901,1094,AR,56,31,25,0,1v1 Random Map
2497844,Kikurage,12903,1094,DE,67,34,33,0,1v1 Random Map
2489123,Wingblade9447,12904,1094,NA,20,11,9,0,1v1 Random Map
2435730,Rodrigo,12906,1094,AR,53,27,26,1,1v1 Random Map
330392,riento,12926,1094,FR,228,115,113,12,1v1 Random Map
1623921,stevenpacilio,12928,1094,US,479,245,234,15,1v1 Random Map
1541055,twitch.com/ageofempiresturkiye,12931,1094,TR,16,9,7,0,1v1 Random Map
1141290,Only MIRAGE// WALL,12936,1093,AR,40,23,17,0,1v1 Random Map
234854,Henburger,12961,1093,DE,12,6,6,0,1v1 Random Map
2479874,choramais,12971,1093,CL,12,6,6,0,1v1 Random Map
1352406,Re1gnover,13006,1093,US,137,76,61,0,1v1 Random Map
1237580,NoHazard(Zae),13009,1093,FR,84,46,38,2,1v1 Random Map
1043297,[KSK] Stener™,13015,1092,DE,175,92,83,0,1v1 Random Map
524651,King Maikelu II,13027,1092,BE,16,7,9,0,1v1 Random Map
2083027,tevo011,13047,1092,PY,23,11,12,1,1v1 Random Map
1987837,LifeNote,13052,1092,FR,16,8,8,0,1v1 Random Map
1834082,Fiskmåsen,13057,1092,SE,102,53,49,4,1v1 Random Map
1470304,Zamaa,13073,1092,AR,34,17,17,0,1v1 Random Map
888527,Sli0n,13098,1091,LU,93,50,43,0,1v1 Random Map
519968,boda_do_age,13112,1091,BR,29,17,12,5,1v1 Random Map
2615501,Tulcas,13125,1091,AT,10,5,5,0,1v1 Random Map
2577538,Zeron,13126,1091,AR,13,7,6,0,1v1 Random Map
1825870,Trufelli,13147,1091,BR,29,14,15,0,1v1 Random Map
1581058,asmathi,13152,1091,FR,64,33,31,1,1v1 Random Map
1301743,Lazvy,13162,1091,FR,339,172,167,8,1v1 Random Map
289158,Nite_Noble24,13167,1091,US,20,3,17,0,1v1 Random Map
650366,LUCHOPAY12,13187,1090,NA,105,55,50,0,1v1 Random Map
246902,VariableBull320,13189,1090,NA,241,124,117,11,1v1 Random Map
519739,YMI2L8,13194,1090,DE,58,30,28,2,1v1 Random Map
2566865,Flashpool,13202,1090,DE,20,11,9,0,1v1 Random Map
2056050,Lord|Bopp,13220,1090,CL,18,10,8,0,1v1 Random Map
2005051,Shulian,13221,1090,AR,15,7,8,1,1v1 Random Map
1531314,^^6-=MajorEjaculate=-,13227,1090,CH,27,16,11,1,1v1 Random Map
309538,Ashla,13229,1090,US,17,8,9,0,1v1 Random Map
1653425,sprEEEzy,13287,1089,HR,45,23,22,0,1v1 Random Map
226314,Arkarius,13327,1088,DE,17,9,8,0,1v1 Random Map
2462191,Sehzade,13330,1088,AT,16,9,7,0,1v1 Random Map
1269171,Uli,13365,1088,DE,134,68,66,5,1v1 Random Map
1067071,lumpyyy,13370,1087,DE,138,73,65,0,1v1 Random Map
994519,Armaluz,13374,1087,CL,25,16,9,0,1v1 Random Map
762989,Nico Lyto Gg,13383,1087,CL,55,30,25,1,1v1 Random Map
541777,LaFlamaBlanca,13387,1087,SE,114,61,53,2,1v1 Random Map
2556255,jsc,13395,1087,GB,15,5,10,0,1v1 Random Map
383248,rudeaugusto,13399,1087,PE,130,66,64,4,1v1 Random Map
2211767,Satya Erebea,13406,1087,NA,19,10,9,1,1v1 Random Map
1953846,WitcheR,13411,1087,TR,361,188,173,3,1v1 Random Map
1918515,kartoffel,13413,1087,DE,25,12,13,2,1v1 Random Map
304510,Vicebu,13420,1087,CA,36,21,15,0,1v1 Random Map
202605,JaneDoe,13455,1086,DE,18,11,7,0,1v1 Random Map
2263883,[31] EnjoyLonely,13463,1086,HK,129,61,68,0,1v1 Random Map
1873601,Milian,13478,1086,DE,104,56,48,2,1v1 Random Map
1693433,LT21,13487,1086,DE,63,32,31,1,1v1 Random Map
910803,Meetjeslander,13510,1085,BE,94,47,47,1,1v1 Random Map
248824,YE,13518,1085,TW,181,94,87,7,1v1 Random Map
2156808,Abebroham Lincoln,13537,1085,NZ,10,6,4,0,1v1 Random Map
318808,CamRoth,13555,1085,US,76,42,34,2,1v1 Random Map
844845,Rocka 1,13570,1084,MX,29,15,14,1,1v1 Random Map
492088,Karzoffl,13584,1084,DE,19,10,9,0,1v1 Random Map
438691,Ghost,13585,1084,US,76,41,35,0,1v1 Random Map
2340929,Deft,13597,1084,MX,66,33,33,3,1v1 Random Map
1832756,Vuil Zwijn,13619,1084,BE,56,27,29,2,1v1 Random Map
1407140,2762419051,13627,1084,CN,44,21,23,1,1v1 Random Map
872652,cyaozu,13638,1083,JP,412,211,201,1,1v1 Random Map
517794,Snøvsen,13653,1083,DK,88,43,45,1,1v1 Random Map
2581876,Derzeon,13659,1083,CO,62,33,29,1,1v1 Random Map
293288,Bean Dip,13687,1083,US,105,54,51,0,1v1 Random Map
278714,tiro,13694,1082,DE,55,29,26,1,1v1 Random Map
671783,FenixMexicano,13708,1082,MX,136,70,66,4,1v1 Random Map
237507,PapaJohn,13712,1082,GR,72,36,36,4,1v1 Random Map
2493659,[J.C.],13724,1082,AR,16,8,8,0,1v1 Random Map
499560,BrYaN,13778,1081,HK,11,6,5,0,1v1 Random Map
2319911,Widowmaker,13791,1081,DE,16,9,7,5,1v1 Random Map
2165687,GregTheGreatest,13796,1081,AT,25,12,13,0,1v1 Random Map
2155619,RuMoe,13797,1081,DE,26,11,15,4,1v1 Random Map
2125541,Belisario430,13798,1081,IT,19,9,10,0,1v1 Random Map
1508428,XD108,13810,1081,HK,51,27,24,0,1v1 Random Map
303894,Bono,13816,1081,US,26,14,12,0,1v1 Random Map
1417397,SlothKing,13817,1081,IT,70,35,35,5,1v1 Random Map
1033913,i ruin game,13829,1080,US,240,124,116,3,1v1 Random Map
245895,Luquitass,13840,1080,AR,10,6,4,2,1v1 Random Map
544321,Galnar,13843,1080,DE,13,5,8,0,1v1 Random Map
2141722,white rabbit,13873,1080,TR,159,77,82,0,1v1 Random Map
1512062,Antjies,13892,1080,BE,145,75,70,10,1v1 Random Map
283364,nestor the argonaut,13903,1079,GB,245,126,119,10,1v1 Random Map
214689,_Stevo_,13978,1078,AT,35,18,17,2,1v1 Random Map
643572,MannyMcCarthy,13997,1078,US,388,197,191,5,1v1 Random Map
2578547,Jackie Chan,14006,1078,SE,20,10,10,0,1v1 Random Map
2537245,king0ld,14007,1078,DO,61,32,29,8,1v1 Random Map
1393181,THE CUSQUEÑO OF GOLD,14047,1078,PE,164,88,76,22,1v1 Random Map
2496729,iRRe&b,14085,1077,FR,90,48,42,2,1v1 Random Map
2099541,WolveDragon,14096,1077,NA,171,89,82,1,1v1 Random Map
1987573,Shadow91,14098,1077,AU,132,71,61,1,1v1 Random Map
1892196,JoeSham,14100,1077,CZ,76,38,38,0,1v1 Random Map
1657869,makkummee,14104,1077,FI,88,43,45,1,1v1 Random Map
1314131,Decize,14114,1077,SE,323,163,160,2,1v1 Random Map
1228358,Liopoldo,14116,1077,ES,111,56,55,1,1v1 Random Map
214804,Orri - Snow Killer,14119,1076,FR,50,30,20,0,1v1 Random Map
569063,santiru01,14140,1076,CO,38,18,20,0,1v1 Random Map
2470376,NthJeff,14153,1076,AU,22,12,10,0,1v1 Random Map
2404296,yvzbaba,14158,1076,NA,98,50,48,1,1v1 Random Map
372385,mateo,14162,1076,PL,24,13,11,1,1v1 Random Map
222736,MortelentaBR,14166,1076,BR,69,36,33,6,1v1 Random Map
1378373,Maître Pingouin,14194,1076,FR,30,14,16,0,1v1 Random Map
1329635,Grgo,14200,1076,SK,38,19,19,0,1v1 Random Map
407797,SilverAflame,14235,1075,US,252,127,125,4,1v1 Random Map
2377899,TytanTroll,14247,1075,GB,20,10,10,0,1v1 Random Map
2335962,Vailean,14249,1075,CA,32,16,16,3,1v1 Random Map
2252900,Bukulak,14255,1075,CZ,49,28,21,0,1v1 Random Map
2216704,Adaloth,14258,1075,AR,17,10,7,0,1v1 Random Map
1902539,Lotus,14268,1075,US,135,69,66,3,1v1 Random Map
849949,[Sparta] BumsKunz,14301,1074,DE,103,56,47,0,1v1 Random Map
2135750,LilTro44,14332,1074,US,23,13,10,0,1v1 Random Map
1665542,kah23,14347,1074,US,10,6,4,0,1v1 Random Map
30775,El Bromas,14352,1074,AR,85,46,39,2,1v1 Random Map
1448632,Dadew,14355,1074,FR,41,19,22,0,1v1 Random Map
1207803,HSE? Milfbasher,14360,1074,DE,34,17,17,0,1v1 Random Map
1126516,VRP,14363,1073,RU,62,35,27,1,1v1 Random Map
738411,Karol Dance Degenerado,14373,1073,CL,14,8,6,0,1v1 Random Map
670076,Bud,14375,1073,US,12,6,6,0,1v1 Random Map
575130,Mikk,14378,1073,DE,33,18,15,1,1v1 Random Map
2532188,CHAO si smART,14387,1073,NA,184,96,88,3,1v1 Random Map
1726685,{GTD} Charmeur18,14411,1073,FR,34,19,15,4,1v1 Random Map
268489,rastadu62,14427,1072,FR,108,59,49,3,1v1 Random Map
2574024,Stepič,14449,1072,PL,51,26,25,3,1v1 Random Map
327409,DULO,14469,1072,BG,57,25,32,2,1v1 Random Map
278888,Eh_chavo,14483,1071,PE,31,17,14,0,1v1 Random Map
761223,frosty6731,14489,1071,US,194,98,96,3,1v1 Random Map
1592657,lk5896338,14548,1071,AU,153,81,72,9,1v1 Random Map
1030530,yoyomannyoyo,14564,1070,TW,225,118,107,7,1v1 Random Map
262840,Noobmaster69,14573,1070,DE,105,55,50,3,1v1 Random Map
673468,Ace0fSpad3s,14582,1070,RS,13,7,6,0,1v1 Random Map
502132,Cuidabichis,14588,1070,MX,41,22,19,2,1v1 Random Map
405175,Al-Iskander,14592,1070,MX,236,113,123,0,1v1 Random Map
319899,Drumstick47,14616,1070,CA,292,147,145,3,1v1 Random Map
1579607,Sin-Eater,14618,1070,ZA,131,73,58,22,1v1 Random Map
214861,freshwholemilk,14637,1069,DE,16,9,7,0,1v1 Random Map
871905,avalancha,14644,1069,DE,59,29,30,0,1v1 Random Map
225494,SpekBo,14663,1069,CZ,21,12,9,0,1v1 Random Map
2439082,Arbuz Budesh,14667,1069,UA,40,21,19,1,1v1 Random Map
380759,HamsterofDoom,14669,1069,US,141,72,69,1,1v1 Random Map
1077816,VicXiaoQ5!,14705,1068,AR,800,402,398,33,1v1 Random Map
793793,Bobskii,14714,1068,GB,16,6,10,0,1v1 Random Map
250509,JJ_Ronda,14715,1068,US,21,11,10,1,1v1 Random Map
2690531,Endless,14730,1068,HK,24,12,12,0,1v1 Random Map
2655608,Basse,14731,1068,DE,13,5,8,0,1v1 Random Map
2091849,lambinamtor,14739,1068,NZ,69,36,33,0,1v1 Random Map
2036237,Onlytiger,14742,1068,US,210,107,103,0,1v1 Random Map
1964726,WetSteak,14746,1068,DE,35,17,18,0,1v1 Random Map
1130408,Ace De Uno,14766,1067,US,12,7,5,0,1v1 Random Map
799142,MADOSKA,14776,1067,AR,16,8,8,0,1v1 Random Map
718437,Madsmuffi,14778,1067,DK,50,26,24,0,1v1 Random Map
2343196,The Yellow Worm,14802,1067,CO,13,7,6,0,1v1 Random Map
1476609,Failed Math Test,14823,1067,CA,45,25,20,2,1v1 Random Map
877730,antonienberthe,14837,1066,FR,363,188,175,4,1v1 Random Map
631680,Jenkemite,14845,1066,CA,153,78,75,0,1v1 Random Map
608232,MAXYVEEEEE,14846,1066,US,23,12,11,2,1v1 Random Map
1650175,cru7i,14884,1066,DE,182,95,87,10,1v1 Random Map
1524436,sithlord,14890,1066,TR,101,50,51,0,1v1 Random Map
1065732,Cancer Foundation,14900,1065,DE,339,171,168,6,1v1 Random Map
2401189,Pitinhas487,14923,1065,NA,69,37,32,0,1v1 Random Map
2112305,troof,14931,1065,US,17,5,12,0,1v1 Random Map
1718690,EH-EH-RON,14947,1065,US,11,6,5,0,1v1 Random Map
1563046,HappilyNomadic,14949,1065,GB,185,95,90,5,1v1 Random Map
607931,Jan,14977,1064,NL,17,9,8,0,1v1 Random Map
1492125,XitT,15019,1064,VN,39,20,19,0,1v1 Random Map
925323,Vroomer,15039,1063,CZ,58,29,29,6,1v1 Random Map
268807,raphael.foscarini,15040,1063,BR,278,141,137,14,1v1 Random Map
2606172,jeanetkat,15062,1063,BE,15,8,7,0,1v1 Random Map
2212723,Chiabex,15076,1063,US,32,16,16,0,1v1 Random Map
1627080,Tsure_CZ,15092,1063,CZ,92,47,45,0,1v1 Random Map
1556041,Guby,15149,1062,DE,21,9,12,0,1v1 Random Map
2570725,此间少年,15186,1061,CN,121,62,59,2,1v1 Random Map
592508,時間管理羅老師,15245,1060,TW,17,9,8,0,1v1 Random Map
1741357,Kresaux,15275,1060,HR,53,26,27,0,1v1 Random Map
1585574,WhichCraft?,15280,1060,AU,107,58,49,0,1v1 Random Map
1152198,RomanClaw856036,15291,1059,NA,18,7,11,0,1v1 Random Map
901563,Tapsin,15302,1059,CL,10,5,5,0,1v1 Random Map
257300,Anubis_Soldier,15305,1059,MX,57,26,31,0,1v1 Random Map
222913,[FaZe] Frock!?,15332,1059,NL,23,12,11,1,1v1 Random Map
401537,aj.jr,15388,1058,MX,23,9,14,0,1v1 Random Map
2570346,Lacedemonio,15390,1058,AR,16,8,8,0,1v1 Random Map
2131886,Theredcore,15402,1058,US,225,117,108,0,1v1 Random Map
1807530,Fadutzu,15410,1058,RO,262,137,125,3,1v1 Random Map
26544,kol9000,15416,1058,DE,38,20,18,2,1v1 Random Map
1068976,Freekill,15426,1058,DE,80,41,39,0,1v1 Random Map
591146,War_Beast,15453,1057,AU,640,322,318,5,1v1 Random Map
236878,Jan,15456,1057,DE,36,12,24,0,1v1 Random Map
2500586,Asta,15470,1057,AR,39,22,17,2,1v1 Random Map
222052,Timerio,15481,1057,AR,42,23,19,0,1v1 Random Map
1981211,PsyQor,15484,1057,AU,44,21,23,0,1v1 Random Map
1137630,CallMeNamaren,15516,1056,AT,157,82,75,5,1v1 Random Map
84383,Imperfectly,15524,1056,DE,23,11,12,0,1v1 Random Map
2629647,SixtyNice,15543,1056,AU,21,10,11,0,1v1 Random Map
2574776,George Costanza,15545,1056,ZA,14,8,6,0,1v1 Random Map
793215,Kasparus,15600,1055,PL,56,34,22,3,1v1 Random Map
736721,Monk,15601,1055,CA,32,17,15,3,1v1 Random Map
239242,sheepinbigcity,15605,1055,US,131,70,61,10,1v1 Random Map
2250002,melonne,15627,1055,FR,12,3,9,0,1v1 Random Map
2242338,ADESu,15628,1055,ES,16,9,7,0,1v1 Random Map
2138811,Копатыч,15629,1055,RU,46,26,20,3,1v1 Random Map
1885524,Dag,15637,1055,NO,23,11,12,0,1v1 Random Map
1260648,Spyro345,15656,1055,US,21,11,10,0,1v1 Random Map
273808,MooseMooch,15667,1054,DE,1318,660,658,32,1v1 Random Map
720855,Buzzplash ⭕⃤,15677,1054,DE,17,7,10,0,1v1 Random Map
2413956,Geile Giraffe,15700,1054,DE,87,48,39,1,1v1 Random Map
224681,Sabbalot,15703,1054,DE,13,7,6,0,1v1 Random Map
2400988,Nepia47,15704,1054,GB,54,27,27,2,1v1 Random Map
2171920,Pointyboykilla,15709,1054,AU,162,86,76,3,1v1 Random Map
1200135,Valorun,15738,1054,FR,54,28,26,1,1v1 Random Map
920044,Nilerua,15746,1053,FR,163,85,78,10,1v1 Random Map
793738,AoE_Euer_Juergen,15752,1053,DE,55,31,24,1,1v1 Random Map
613047,God Mode,15762,1053,US,267,135,132,12,1v1 Random Map
2666826,_[eC]_SamueL_,15769,1053,IT,45,22,23,1,1v1 Random Map
2634400,Koke Silva,15770,1053,CL,15,7,8,0,1v1 Random Map
401969,Investigate311,15771,1053,US,43,20,23,0,1v1 Random Map
2457056,ROOR Ripps,15776,1053,NA,141,74,67,1,1v1 Random Map
372169,MasterLuks,15786,1053,DE,47,25,22,3,1v1 Random Map
1743754,Nacre,15806,1053,US,479,245,234,5,1v1 Random Map
988417,sungyy,15828,1052,US,17,8,9,0,1v1 Random Map
267180,o3li*,15829,1052,DE,164,85,79,4,1v1 Random Map
896612,MurphQuake,15830,1052,GB,63,34,29,3,1v1 Random Map
24026,Schnorks,15833,1052,DE,57,29,28,0,1v1 Random Map
401685,_thezonzolo_,15853,1052,GB,87,47,40,0,1v1 Random Map
1958605,JohnnyAc,15871,1052,GP,78,38,40,5,1v1 Random Map
1816134,"Mesk, O Especial",15876,1052,BR,10,5,5,0,1v1 Random Map
1762799,ninja,15881,1052,HK,95,52,43,3,1v1 Random Map
1589080,TiggerX22,15884,1052,DE,13,7,6,0,1v1 Random Map
391996,EvoUnnamed,15923,1051,US,250,129,121,1,1v1 Random Map
2431321,chwiens,15924,1051,US,22,12,10,0,1v1 Random Map
2093613,Moley,15936,1051,CA,109,58,51,1,1v1 Random Map
2047531,Core Ona,15937,1051,CH,21,11,10,0,1v1 Random Map
1808172,Big Boss lVl,15946,1051,US,64,35,29,0,1v1 Random Map
1742774,SeGomismo,15947,1051,NA,66,34,32,0,1v1 Random Map
323976,Cryptosaurus,15951,1051,MX,275,141,134,24,1v1 Random Map
538256,Ouroboros,15989,1050,NL,31,14,17,0,1v1 Random Map
2652096,Blitti,15992,1050,NO,57,29,28,0,1v1 Random Map
2537009,Josfhat,15994,1050,CA,32,16,16,0,1v1 Random Map
2033790,宝剑X,16016,1050,CN,55,29,26,0,1v1 Random Map
2019916,mmmmmm,16018,1050,US,26,12,14,0,1v1 Random Map
218145,slumlord,16027,1050,CH,161,84,77,2,1v1 Random Map
1372868,Ω Migate no Omega Ω,16037,1050,CL,27,13,14,4,1v1 Random Map
284514,Boom Boom Room,16043,1049,GB,194,99,95,2,1v1 Random Map
255456,Friedl,16055,1049,DE,46,24,22,3,1v1 Random Map
2683723,Pipemaster28,16066,1049,CO,49,25,24,2,1v1 Random Map
2503168,Scarecrow Boat,16071,1049,US,16,8,8,1,1v1 Random Map
2480712,lele,16073,1049,TR,59,30,29,1,1v1 Random Map
2089013,sunlight07,16085,1049,CN,10,4,6,0,1v1 Random Map
1456980,spacevinc,16106,1049,FR,18,9,9,0,1v1 Random Map
881421,pisrael,16117,1048,BR,63,31,32,3,1v1 Random Map
455039,Jasper,16135,1048,NL,173,90,83,1,1v1 Random Map
400498,G0ld13,16140,1048,US,22,8,14,2,1v1 Random Map
1748770,GentlemanPyro,16174,1048,CA,21,11,10,0,1v1 Random Map
1470056,Alexsieflexi,16183,1048,NA,121,64,57,0,1v1 Random Map
1950648,Tea-Man,16241,1047,VN,97,48,49,2,1v1 Random Map
1365200,Sugarplum,16255,1047,GB,235,121,114,4,1v1 Random Map
883516,Gleipnir,16263,1046,CA,21,11,10,0,1v1 Random Map
245244,Sebastian Velez,16271,1046,CO,26,13,13,0,1v1 Random Map
2454325,BERY,16278,1046,US,15,8,7,0,1v1 Random Map
2416126,Magheeta,16279,1046,GB,32,15,17,0,1v1 Random Map
2315093,Klaus,16285,1046,AT,59,30,29,0,1v1 Random Map
1989208,Rosdenar,16297,1046,DE,15,5,10,0,1v1 Random Map
1442848,kenight,16309,1046,HK,42,21,21,0,1v1 Random Map
1356947,niour,16310,1046,GR,129,65,64,1,1v1 Random Map
1003098,Scheppie,16322,1045,NL,67,36,31,1,1v1 Random Map
2674978,Myw,16331,1045,TR,21,10,11,1,1v1 Random Map
2625937,RednachS,16334,1045,IN,14,7,7,0,1v1 Random Map
1589139,lorgoyf,16368,1045,DE,380,192,188,20,1v1 Random Map
242469,schwazza,16396,1044,DE,25,11,14,0,1v1 Random Map
1953581,lazaro2201,16430,1044,FR,42,20,22,2,1v1 Random Map
313583,RocoDW,16444,1044,MX,11,6,5,1,1v1 Random Map
308499,DaveX.ve,16448,1044,MX,513,258,255,7,1v1 Random Map
995040,paradisebird,16463,1043,FR,127,66,61,1,1v1 Random Map
892281,Divisibleby0,16468,1043,US,111,56,55,1,1v1 Random Map
623761,FacundoBernardez89,16478,1043,AR,92,49,43,5,1v1 Random Map
2360919,AOEgod1995,16499,1043,GB,23,12,11,0,1v1 Random Map
1662012,Real Tom,16516,1043,US,13,7,6,0,1v1 Random Map
1261379,Confidant,16527,1043,DE,11,6,5,0,1v1 Random Map
1247093,Shreaky,16528,1043,IN,85,43,42,4,1v1 Random Map
949767,koky,16538,1042,FR,17,10,7,0,1v1 Random Map
918569,Angryhippo2910,16539,1042,CA,40,18,22,1,1v1 Random Map
408396,JoelAndYou,16562,1042,CA,53,29,24,0,1v1 Random Map
1788514,TopDrilla,16591,1042,GB,77,41,36,1,1v1 Random Map
1076902,SkiesAreRed,16607,1041,CZ,97,50,47,4,1v1 Random Map
943812,Badblood,16611,1041,NO,17,8,9,0,1v1 Random Map
544830,Supertramp,16625,1041,DE,362,182,180,6,1v1 Random Map
493219,raskidu63,16627,1041,FR,65,34,31,0,1v1 Random Map
474731,NotUseful,16630,1041,US,12,3,9,0,1v1 Random Map
1844135,Cerise IV,16662,1041,NA,22,11,11,1,1v1 Random Map
1838013,Gusano1186,16663,1041,NA,74,41,33,1,1v1 Random Map
1153965,porotos con rienda,16673,1040,CL,179,92,87,11,1v1 Random Map
578428,Blue,16684,1040,GB,68,38,30,0,1v1 Random Map
574957,The King in the North,16685,1040,AT,376,190,186,20,1v1 Random Map
2713375,Lonely Barrel,16697,1040,SK,24,11,13,0,1v1 Random Map
2628165,Carlos Messina,16701,1040,AR,70,32,38,0,1v1 Random Map
1975903,alealdo,16720,1040,AR,76,38,38,1,1v1 Random Map
891211,Feelooo,16754,1039,NA,211,108,103,8,1v1 Random Map
137455,Denster,16763,1039,DE,16,8,8,0,1v1 Random Map
2690497,GHALILBABA,16774,1039,AU,11,7,4,0,1v1 Random Map
2271197,conkër,16790,1039,CL,49,24,25,0,1v1 Random Map
1356734,Camelo04,16812,1039,DE,64,33,31,3,1v1 Random Map
1114186,Dave Jones,16816,1038,DE,33,17,16,0,1v1 Random Map
2086834,Unicorn73,16867,1038,GB,35,17,18,0,1v1 Random Map
339511,血矢筑,16875,1038,JP,13,7,6,0,1v1 Random Map
1636301,Moonape,16879,1038,FR,151,79,72,2,1v1 Random Map
1576346,GoGoGadget-DownToOne,16880,1038,AU,26,12,14,1,1v1 Random Map
947152,itipt1993,16899,1037,US,329,169,160,15,1v1 Random Map
2161087,Canooski,16933,1037,US,45,21,24,0,1v1 Random Map
1829389,KleeSchnee,16948,1037,NA,125,66,59,1,1v1 Random Map
637761,El Azote,16988,1036,CO,64,32,32,1,1v1 Random Map
453467,Karin Ritter,16996,1036,DE,81,42,39,0,1v1 Random Map
385322,LG_Blace,17011,1036,DE,57,28,29,3,1v1 Random Map
2188887,lil papa,17018,1036,US,71,34,37,3,1v1 Random Map
1908968,ppL™,17026,1036,DE,60,34,26,0,1v1 Random Map
1684710,Alter pro,17035,1036,US,19,10,9,0,1v1 Random Map
1510665,JourneyofaNoob,17039,1036,TR,71,37,34,1,1v1 Random Map
1206764,Blackened,17045,1036,US,15,8,7,0,1v1 Random Map
486616,Zorynox,17067,1035,FR,14,7,7,0,1v1 Random Map
389249,DerPanzermensch,17079,1035,AR,45,22,23,1,1v1 Random Map
2439588,Noweehustl,17082,1035,US,25,12,13,0,1v1 Random Map
384931,[TNW] Jminsanity,17084,1035,US,48,24,24,2,1v1 Random Map
359878,Kesari superman,17095,1035,IN,53,25,28,5,1v1 Random Map
1830062,Brunoganster25,17107,1035,MX,123,62,61,8,1v1 Random Map
412753,Oceanchief,17149,1034,US,57,31,26,1,1v1 Random Map
2020402,SLicE5647,17170,1034,NA,37,18,19,0,1v1 Random Map
1790550,LeMelonChopper,17177,1034,US,82,42,40,0,1v1 Random Map
1500783,bbsebb,17188,1034,FR,16,6,10,0,1v1 Random Map
1068936,AndFre,17198,1033,DE,65,33,32,0,1v1 Random Map
2102082,KULAga,17243,1033,RU,16,4,12,0,1v1 Random Map
345547,The A-Factor,17251,1033,AU,111,57,54,2,1v1 Random Map
1892207,Randalf,17256,1033,DE,76,38,38,1,1v1 Random Map
1678910,PanikMuenze284,17262,1033,NA,184,93,91,1,1v1 Random Map
1289884,Enlightened Fox,17272,1033,GB,24,12,12,0,1v1 Random Map
1216828,branflakes1337,17274,1033,NA,81,45,36,0,1v1 Random Map
727120,Roneleth,17289,1032,US,273,140,133,1,1v1 Random Map
539455,Foley,17297,1032,DE,139,72,67,9,1v1 Random Map
2192356,KJEMPEBRA,17318,1032,NO,106,57,49,0,1v1 Random Map
308231,gcg83,17343,1032,US,12,5,7,0,1v1 Random Map
125198,LookdeeZElemelons,17365,1031,CA,11,5,6,0,1v1 Random Map
930052,frezx,17366,1031,DE,84,43,41,2,1v1 Random Map
431835,ERRICOS4,17392,1031,AU,11,4,7,0,1v1 Random Map
2348358,Suppe,17404,1031,DE,19,9,10,0,1v1 Random Map
2085680,Fo9ma,17412,1031,DE,57,30,27,1,1v1 Random Map
1653228,merhimoro,17433,1031,PT,133,69,64,0,1v1 Random Map
1217353,lawrencelpy,17441,1031,HK,40,19,21,0,1v1 Random Map
868494,erickdv32,17449,1030,MX,19,10,9,0,1v1 Random Map
840985,cornikeks,17450,1030,DE,12,4,8,0,1v1 Random Map
1954721,jungleism.monkey,17489,1030,DE,72,36,36,0,1v1 Random Map
1951454,EJ,17490,1030,TW,50,26,24,0,1v1 Random Map
1718331,boyar_orlov,17500,1030,FR,34,18,16,2,1v1 Random Map
1556285,Sessto,17504,1030,DE,30,14,16,0,1v1 Random Map
942382,Simon,17517,1029,DE,37,19,18,0,1v1 Random Map
791521,xX † KlötenKarl † Xx,17524,1029,DE,75,42,33,0,1v1 Random Map
2402092,𐂃,17547,1029,ZA,20,10,10,0,1v1 Random Map
296128,goldkeys,17574,1029,CA,14,7,7,0,1v1 Random Map
1282116,yopkool,17577,1029,FR,168,87,81,7,1v1 Random Map
292924,tromto,17578,1029,US,556,281,275,7,1v1 Random Map
239532,superpizza,17601,1028,FR,103,54,49,1,1v1 Random Map
2476892,Skelter,17613,1028,AR,11,6,5,0,1v1 Random Map
2345950,legomanyak,17619,1028,TR,102,55,47,2,1v1 Random Map
2103808,Critizie,17626,1028,DE,21,8,13,1,1v1 Random Map
1943353,fooolik,17639,1028,FR,33,16,17,1,1v1 Random Map
1844499,Filipusis92,17642,1028,NA,92,49,43,2,1v1 Random Map
1415152,bluemountain,17656,1028,TW,35,19,16,0,1v1 Random Map
758066,Outlawuser3,17675,1027,SI,44,21,23,0,1v1 Random Map
2044881,Dadine,17705,1027,FR,30,15,15,0,1v1 Random Map
2032824,Günther-Strike,17706,1027,CA,59,31,28,1,1v1 Random Map
1880182,saturas,17714,1027,CH,39,20,19,1,1v1 Random Map
1839346,NeedaMedic,17716,1027,GB,30,16,14,0,1v1 Random Map
1555484,Kejiii,17725,1027,CL,107,54,53,2,1v1 Random Map
1041725,spunkete,17746,1026,GB,12,5,7,0,1v1 Random Map
898154,Kraamito,17749,1026,BE,370,186,184,6,1v1 Random Map
612131,Fat & Juan,17757,1026,US,107,55,52,1,1v1 Random Map
544303,"The Forgotten Boar Rising:,'(",17760,1026,DE,90,45,45,0,1v1 Random Map
226174,julian_gs21,17772,1026,CO,14,6,8,1,1v1 Random Map
2544879,xus90c,17773,1026,ES,16,8,8,0,1v1 Random Map
1147970,GUZA,17809,1025,NL,160,82,78,2,1v1 Random Map
1006630,Boanerges♂,17814,1025,CL,86,44,42,2,1v1 Random Map
2374475,FallenAngel,17844,1025,US,87,48,39,0,1v1 Random Map
2211552,Tomaaaszek,17847,1025,NA,10,4,6,1,1v1 Random Map
2158962,Patredway,17850,1025,MQ,33,16,17,0,1v1 Random Map
1719530,Tyrune,17865,1025,DE,13,6,7,0,1v1 Random Map
1635138,matiasmdelp,17868,1025,AR,24,11,13,2,1v1 Random Map
1073335,ilikeslicebread,17883,1024,BH,74,37,37,5,1v1 Random Map
2374441,Leo,17913,1024,BR,107,55,52,3,1v1 Random Map
1806876,Apathetical,17935,1024,TR,58,22,36,0,1v1 Random Map
1716093,lefko))),17940,1024,DE,10,5,5,0,1v1 Random Map
1555424,jorgeanmora,17944,1024,AR,32,15,17,7,1v1 Random Map
1486946,TrueDisplay,17946,1024,CA,36,19,17,0,1v1 Random Map
1308529,./Bichito de luZ,17954,1024,FR,22,10,12,0,1v1 Random Map
844168,Djonaar,17974,1023,FR,16,4,12,0,1v1 Random Map
818083,human bean,17977,1023,FR,102,53,49,2,1v1 Random Map
231573,Silence,17987,1023,US,22,11,11,0,1v1 Random Map
387806,King Astesh,18000,1023,CA,37,19,18,0,1v1 Random Map
2385419,WiSeMaN,18005,1023,TH,27,9,18,4,1v1 Random Map
1870627,VirginBuster,18018,1023,CA,110,55,55,9,1v1 Random Map
1402147,Tsla420yoloswaghetti,18035,1023,CH,28,16,12,0,1v1 Random Map
1011456,Thales,18044,1022,BR,26,15,11,7,1v1 Random Map
2698298,wiliamrodriguessk,18065,1022,BR,22,9,13,0,1v1 Random Map
2147267,Odiseo,18075,1022,CO,12,6,6,1,1v1 Random Map
281561,DanyDuke_IV,18107,1021,FR,264,134,130,0,1v1 Random Map
642809,thenewflesh,18116,1021,GB,22,10,12,0,1v1 Random Map
2534893,parcero9576,18131,1021,NA,54,25,29,2,1v1 Random Map
2036810,jmerice93,18151,1021,ES,110,56,54,0,1v1 Random Map
1821979,LaLo,18158,1021,US,192,102,90,3,1v1 Random Map
325577,walrusman7777,18164,1021,US,131,67,64,1,1v1 Random Map
648330,Lord Frosch,18201,1020,DE,54,28,26,0,1v1 Random Map
1264409,King Arthur,18249,1020,AR,26,11,15,1,1v1 Random Map
1038335,Twizzler,18258,1019,CA,268,133,135,3,1v1 Random Map
2485377,Terra,18279,1019,AR,27,13,14,0,1v1 Random Map
2299519,Kueschii,18282,1019,CH,23,10,13,0,1v1 Random Map
2258547,Scamazon,18284,1019,IE,19,11,8,0,1v1 Random Map
790494,joshgav,18319,1018,US,149,74,75,2,1v1 Random Map
75109,TwoJarl7,18324,1018,NA,147,74,73,4,1v1 Random Map
406237,gilgamesh,18331,1018,US,16,7,9,0,1v1 Random Map
2223968,MrPortcullis,18345,1018,GB,47,22,25,0,1v1 Random Map
312401,haganmchenry,18355,1018,US,38,17,21,0,1v1 Random Map
1030715,Oneilos,18377,1017,FR,65,37,28,3,1v1 Random Map
275612,sirvaloso,18378,1017,CH,23,10,13,0,1v1 Random Map
447085,Juanrrior,18393,1017,CO,28,12,16,1,1v1 Random Map
1932328,sebaleojo,18420,1017,PE,28,14,14,3,1v1 Random Map
1663468,tv/evilars,18426,1017,UA,33,15,18,0,1v1 Random Map
1336888,Silver Boi,18437,1017,DE,82,42,40,1,1v1 Random Map
1163761,ICM_DOVAKIIN,18447,1016,GB,67,29,38,2,1v1 Random Map
2490200,DeTaFiLL,18472,1016,TR,22,11,11,0,1v1 Random Map
2404842,hotaco_01,18476,1016,PE,72,35,37,0,1v1 Random Map
2054789,m.maaz.kamal,18496,1016,US,11,1,10,1,1v1 Random Map
1597839,Artem der Schäbige,18509,1016,DE,56,22,34,0,1v1 Random Map
1183402,kevin011087,18524,1016,TW,11,6,5,0,1v1 Random Map
1061992,Matoutou27,18526,1015,CA,36,22,14,1,1v1 Random Map
931837,Tamosbien,18529,1015,CO,23,10,13,1,1v1 Random Map
2280390,Helium2268,18555,1015,NA,17,6,11,0,1v1 Random Map
2226966,Mojo,18559,1015,BE,12,6,6,1,1v1 Random Map
343307,Korner,18571,1015,BR,11,5,6,0,1v1 Random Map
1683671,MrHabilis,18580,1015,GB,72,35,37,0,1v1 Random Map
897628,Kementaris,18597,1014,FR,113,59,54,2,1v1 Random Map
1564,Fuhloh,18600,1014,ES,27,13,14,0,1v1 Random Map
247409,philipp9426,18603,1014,DE,183,92,91,8,1v1 Random Map
238578,jamiroquai,18606,1014,DE,357,179,178,5,1v1 Random Map
398379,RealDostoyevski,18622,1014,TR,47,23,24,3,1v1 Random Map
1652721,SkwAnchy,18728,1013,AR,55,31,24,1,1v1 Random Map
211784,Fr2,18753,1012,GB,488,243,245,9,1v1 Random Map
2535425,WannFanne,18766,1012,TR,15,7,8,0,1v1 Random Map
2249641,Abudi,18782,1012,TR,12,6,6,0,1v1 Random Map
2094290,sefakcaoglu,18787,1012,TR,224,115,109,3,1v1 Random Map
1238373,Dodgers Black Mambas Strike <3,18812,1012,TN,170,87,83,9,1v1 Random Map
550134,Ricola,18824,1011,DE,23,12,11,1,1v1 Random Map
439084,El Mudo,18830,1011,EE,73,41,32,0,1v1 Random Map
156262,finalDota2,18831,1011,CN,190,97,93,0,1v1 Random Map
2584876,le_chick,18839,1011,IN,66,31,35,0,1v1 Random Map
2189887,筋肉肥仔,18852,1011,HK,10,5,5,0,1v1 Random Map
1964763,thebouch3,18857,1011,US,122,64,58,9,1v1 Random Map
1875305,Blane,18859,1011,FR,18,9,9,0,1v1 Random Map
1035336,trebuchet,18880,1010,IN,116,57,59,9,1v1 Random Map
259406,Joaksss,18886,1010,ES,51,26,25,3,1v1 Random Map
219966,Boaromir,18915,1010,DE,16,8,8,1,1v1 Random Map
1141095,Kiiwii,18929,1009,BE,71,38,33,0,1v1 Random Map
1758520,clembomb,18987,1009,CA,10,5,5,0,1v1 Random Map
1747449,matias_barckley,18988,1009,ES,27,15,12,0,1v1 Random Map
1622346,Anid.,18992,1009,DE,41,24,17,4,1v1 Random Map
1278495,Seenk,18999,1009,CL,40,19,21,1,1v1 Random Map
975832,RedMax,19005,1008,DE,13,6,7,0,1v1 Random Map
873146,hayashireii,19008,1008,TW,284,144,140,10,1v1 Random Map
691913,Toss a coin,19012,1008,DE,10,5,5,0,1v1 Random Map
251010,Gilbert Stays At Home,19013,1008,HK,131,66,65,3,1v1 Random Map
416961,bluebird,19017,1008,US,176,88,88,1,1v1 Random Map
2444134,Tachindo,19023,1008,NA,59,29,30,0,1v1 Random Map
2438083,Mütemerrit,19024,1008,TR,12,5,7,0,1v1 Random Map
2085954,maelcuff,19034,1008,FR,19,10,9,0,1v1 Random Map
1258604,SoJi,19053,1008,FR,76,40,36,0,1v1 Random Map
1150319,RedSk0rpi0,19057,1007,CO,185,94,91,3,1v1 Random Map
1043588,harrisdavi4,19061,1007,NZ,16,8,8,0,1v1 Random Map
2255259,Infernal,19105,1007,GB,22,11,11,0,1v1 Random Map
1468610,drachs1337,19130,1007,DE,172,87,85,3,1v1 Random Map
1414855,ArgentoXX,19132,1007,ES,15,7,8,0,1v1 Random Map
597130,NateZMate,19154,1006,FR,72,38,34,1,1v1 Random Map
554928,horst691,19155,1006,DE,35,16,19,0,1v1 Random Map
2456458,KAMI MASTER,19171,1006,US,26,13,13,0,1v1 Random Map
1916969,likeboof,19187,1006,FR,23,11,12,0,1v1 Random Map
1046457,zatterc,19207,1005,CH,29,14,15,0,1v1 Random Map
964948,imugemorihasam,19210,1005,DE,71,35,36,6,1v1 Random Map
2297663,jp3013,19238,1005,US,103,57,46,1,1v1 Random Map
2242477,黄天当立,19242,1005,CN,44,23,21,0,1v1 Random Map
984324,Mirothe,19284,1004,US,12,6,6,0,1v1 Random Map
558907,Yirgacheffe,19293,1004,CA,111,56,55,2,1v1 Random Map
2386947,Marxi,19309,1004,DE,10,4,6,0,1v1 Random Map
2080649,tinoso15,19316,1004,ES,75,39,36,0,1v1 Random Map
2004509,Apex,19318,1004,US,48,27,21,0,1v1 Random Map
270890,TDyk6,19350,1003,US,184,95,89,35,1v1 Random Map
674988,Wireless ऊदबिलाव,19362,1003,IN,89,46,43,11,1v1 Random Map
501920,Morzan,19367,1003,DE,27,12,15,1,1v1 Random Map
494040,marchoryaans,19368,1003,NL,34,17,17,0,1v1 Random Map
2558779,DocCox,19375,1003,US,73,37,36,3,1v1 Random Map
2382373,SaDc,19380,1003,CO,40,20,20,0,1v1 Random Map
2543230,lucasmarc,19458,1002,GB,15,6,9,0,1v1 Random Map
2307257,Freshman2025,19467,1002,NA,10,5,5,0,1v1 Random Map
1327340,DonPatricius,19509,1002,NA,26,12,14,3,1v1 Random Map
286821,Daniel,19515,1001,DE,43,23,20,0,1v1 Random Map
1023151,Dzepetto5,19518,1001,GB,51,26,25,1,1v1 Random Map
1008001,Rocar,19519,1001,ES,208,104,104,3,1v1 Random Map
236393,fesakul,19547,1001,DE,66,34,32,0,1v1 Random Map
2165994,Ben3nuts,19566,1001,FR,10,5,5,0,1v1 Random Map
2137381,Bensch,19569,1001,AT,13,7,6,0,1v1 Random Map
1972001,Vipercavy,19573,1001,US,172,88,84,1,1v1 Random Map
1896471,JackOfBlades,19578,1001,CH,38,20,18,0,1v1 Random Map
1478393,BcrS,19585,1001,BR,182,95,87,4,1v1 Random Map
1152223,dobrien180,19597,1000,IE,39,16,23,6,1v1 Random Map
1140373,sam,19598,1000,AU,22,7,15,0,1v1 Random Map
869122,{ST}MQARG,19605,1000,AR,71,38,33,5,1v1 Random Map
772824,Crazy Dux,19608,1000,BE,15,7,8,0,1v1 Random Map
386944,Davjen,19625,1000,IT,25,11,14,1,1v1 Random Map
2372891,Manniacx,19627,1000,BR,11,5,6,3,1v1 Random Map
2222524,bakalov.ivaylo,19633,1000,BG,12,6,6,0,1v1 Random Map
1779255,Loganschloggin,19654,1000,US,45,20,25,3,1v1 Random Map
1681018,VaqueroRey,19656,1000,NA,43,21,22,0,1v1 Random Map
1510698,Kubicek,19660,1000,CZ,25,13,12,0,1v1 Random Map
2446863,DC,19700,999,CO,71,35,36,1,1v1 Random Map
2045871,Genseric,19707,999,US,38,20,18,0,1v1 Random Map
1907339,Sly,19718,999,CH,12,6,6,1,1v1 Random Map
1384929,llStarHadockll,19737,999,MX,130,65,65,1,1v1 Random Map
684070,Stoperu,19759,998,US,216,109,107,5,1v1 Random Map
1991268,Antonio,19797,998,SE,12,4,8,0,1v1 Random Map
1619102,Macri,19817,998,AR,46,23,23,1,1v1 Random Map
966134,HS_Piccolo,19845,997,DE,50,27,23,0,1v1 Random Map
420222,Baltz,19861,997,US,10,5,5,1,1v1 Random Map
2034798,喜咧亂小,19877,997,TW,40,22,18,0,1v1 Random Map
1022428,seydouxh,19910,996,FR,14,7,7,0,1v1 Random Map
962806,Fujichan,19916,996,FR,179,93,86,0,1v1 Random Map
383193,T O I,19947,996,DE,170,90,80,23,1v1 Random Map
2202053,Alko4689,19958,996,NA,42,20,22,0,1v1 Random Map
1787046,[BNooB] MartyMcFly85,19970,996,BE,14,6,8,1,1v1 Random Map
1290904,MarTPoiss,19986,996,EE,20,7,13,0,1v1 Random Map
490894,MatiniusC,20010,995,AU,26,12,14,0,1v1 Random Map
465600,HxV,20012,995,US,46,22,24,0,1v1 Random Map
2229782,[Huso]AndyYYyxD,20024,995,AT,31,16,15,2,1v1 Random Map
1402393,j1805,20054,995,FR,10,5,5,0,1v1 Random Map
611618,Tomi,20080,994,AR,10,3,7,0,1v1 Random Map
2709300,Mala Fama,20086,994,AR,64,33,31,0,1v1 Random Map
2091501,ser,20102,994,AR,12,4,8,0,1v1 Random Map
1889746,ImThaNuts,20115,994,ES,255,125,130,4,1v1 Random Map
1744884,marot.dylan1,20125,994,FR,12,6,6,0,1v1 Random Map
1642214,Wut?,20129,994,US,17,8,9,0,1v1 Random Map
2582012,william.lepine,20172,993,CA,13,6,7,0,1v1 Random Map
2257669,Nicomolinagnr,20188,993,AR,11,5,6,0,1v1 Random Map
368858,Valdegard,20189,993,CH,184,93,91,4,1v1 Random Map
2053747,lsriley77,20194,993,US,28,14,14,0,1v1 Random Map
546058,Bagger,20241,992,DE,89,46,43,11,1v1 Random Map
90751,Akabreaker,20246,992,ES,15,6,9,0,1v1 Random Map
2708418,Yuukinae,20248,992,US,16,8,8,0,1v1 Random Map
2630238,MaTTs,20253,992,AR,29,14,15,0,1v1 Random Map
1677858,Heavensrage,20287,992,US,123,59,64,0,1v1 Random Map
1517447,Duque de Alba,20290,992,AR,85,42,43,1,1v1 Random Map
1026082,the phells,20310,991,NA,26,13,13,2,1v1 Random Map
771319,[HOBO]Bindlestick,20319,991,US,11,3,8,0,1v1 Random Map
2649946,Nanman,20335,991,US,18,9,9,1,1v1 Random Map
2427911,Notorious Guib,20342,991,FR,21,11,10,0,1v1 Random Map
1927972,Rufus,20364,991,DE,44,22,22,0,1v1 Random Map
220940,CBTimaun,20365,991,BR,72,36,36,0,1v1 Random Map
311403,TheHeisenberg,20378,991,MX,32,15,17,1,1v1 Random Map
1029466,SuperPytho,20385,990,FR,313,158,155,6,1v1 Random Map
268893,leonardflp78,20389,990,AU,37,17,20,5,1v1 Random Map
504598,amukara,20398,990,NA,15,7,8,0,1v1 Random Map
2133417,segfaults9,20420,990,CA,101,52,49,1,1v1 Random Map
1842872,AndiValent,20432,990,DE,157,79,78,4,1v1 Random Map
219333,SAM.SEP10L,20440,990,CA,150,73,77,1,1v1 Random Map
1509679,TangoFoxtrot,20446,990,FR,13,6,7,0,1v1 Random Map
1461387,[DK]_HUNTER,20447,990,BR,10,5,5,0,1v1 Random Map
1383558,Legion of Boom,20449,990,AU,26,11,15,0,1v1 Random Map
1175238,JosPunch,20454,989,FR,79,41,38,1,1v1 Random Map
15809,Lile-Insume,20463,989,CH,21,10,11,0,1v1 Random Map
2289731,Seifou,20488,989,DZ,151,75,76,9,1v1 Random Map
2122400,itachigo74ma,20489,989,FR,105,55,50,1,1v1 Random Map
1599049,DakroyHD,20506,989,NA,14,7,7,2,1v1 Random Map
296287,white pony,20516,989,DE,98,48,50,0,1v1 Random Map
2203928,Logicalgoldfish,20559,988,GB,23,11,12,0,1v1 Random Map
1617133,HKAOE5262,20581,988,NA,11,5,6,0,1v1 Random Map
1914343,Azeyle,20625,987,FR,149,77,72,2,1v1 Random Map
1779707,tony122597,20634,987,MO,195,102,93,5,1v1 Random Map
230348,大皮卡,20663,986,TW,109,52,57,1,1v1 Random Map
120282,Rizesc,20674,986,NA,22,10,12,0,1v1 Random Map
362118,mc_the_ribber,20683,986,DE,49,24,25,2,1v1 Random Map
1302453,Peter_Snv,20718,986,BE,79,44,35,1,1v1 Random Map
525407,flopsh0t,20748,985,US,351,182,169,1,1v1 Random Map
2371662,Low.d3t4ils,20759,985,BR,66,34,32,2,1v1 Random Map
1536233,Marty,20795,985,CZ,36,16,20,0,1v1 Random Map
741803,Osin Babosin,20811,984,NA,45,24,21,1,1v1 Random Map
199690,BodokoS,20813,984,NA,12,3,9,0,1v1 Random Map
119471,JinX,20818,984,GB,249,128,121,6,1v1 Random Map
2127465,Dibarom,20848,984,ES,34,18,16,0,1v1 Random Map
1871336,P@yne,20863,984,US,61,32,29,0,1v1 Random Map
217307,TJay,20875,984,DE,32,11,21,0,1v1 Random Map
488971,DocToR,20900,983,TR,18,9,9,0,1v1 Random Map
226498,Vipers,20906,983,GB,34,19,15,0,1v1 Random Map
299868,DC,20943,983,BR,17,9,8,1,1v1 Random Map
1221232,Timoxa1,20946,983,RU,93,48,45,2,1v1 Random Map
615845,Del-Rayfor,20968,982,US,21,10,11,2,1v1 Random Map
2596331,BladedStream450,20976,982,NA,32,15,17,2,1v1 Random Map
2464316,Husky,20981,982,ES,16,8,8,0,1v1 Random Map
1014208,awnorus17,21021,981,NA,34,19,15,0,1v1 Random Map
845229,tdxtik,21028,981,AM,21,9,12,2,1v1 Random Map
245114,adorerofblood,21033,981,ZA,10,4,6,0,1v1 Random Map
92419,[GI MONO] YOPH,21040,981,MX,23,9,14,0,1v1 Random Map
2143093,William Lives,21055,981,ES,44,21,23,1,1v1 Random Map
1794423,bbrages,21066,981,US,12,5,7,1,1v1 Random Map
1578332,mlongpre,21078,981,US,16,8,8,0,1v1 Random Map
315576,zig158,21079,981,US,20,9,11,0,1v1 Random Map
1033948,fontana.federico1991,21092,980,GB,79,40,39,0,1v1 Random Map
2587470,Koxinho,21119,980,FR,50,23,27,0,1v1 Random Map
2354979,Hsueyy,21129,980,US,25,12,13,0,1v1 Random Map
1879226,BolzanoWeierstrass,21152,980,FR,79,41,38,0,1v1 Random Map
1298860,SABIIIIIIIIII,21170,980,FR,21,6,15,1,1v1 Random Map
799291,Myrg,21180,979,AU,19,9,10,1,1v1 Random Map
782643,Polliainen,21184,979,FI,15,7,8,0,1v1 Random Map
2316759,Von Baron,21223,979,AU,60,30,30,3,1v1 Random Map
2057509,Rey David,21235,979,EC,20,9,11,2,1v1 Random Map
1877362,[Fruit] I'm a legal tho,21242,979,US,28,13,15,0,1v1 Random Map
218356,Ye Old William,21252,979,GB,203,102,101,2,1v1 Random Map
1455482,Xender Cage,21256,979,FR,14,4,10,0,1v1 Random Map
106901,JM445,21271,978,FR,32,14,18,0,1v1 Random Map
255569,maxmax,21274,978,TW,112,57,55,1,1v1 Random Map
242141,Mr0life,21281,978,PL,63,31,32,1,1v1 Random Map
2399978,jonospoon,21294,978,NL,11,5,6,0,1v1 Random Map
6729,Devious,21311,978,US,13,7,6,0,1v1 Random Map
1806819,MC_Terminator,21318,978,CA,96,44,52,1,1v1 Random Map
1674226,taskacc1,21321,978,AT,419,209,210,7,1v1 Random Map
1109894,aero,21333,977,GB,145,71,74,4,1v1 Random Map
539027,elmyke,21350,977,DE,16,7,9,0,1v1 Random Map
2565990,MrFox5966,21363,977,NA,14,7,7,0,1v1 Random Map
2012548,JRR,21381,977,AR,36,16,20,1,1v1 Random Map
1980338,Tillia,21384,977,DE,16,7,9,0,1v1 Random Map
129758,Bartuc,21411,976,FR,46,22,24,0,1v1 Random Map
791190,No_One,21413,976,DE,128,64,64,2,1v1 Random Map
2361049,Boowoar,21438,976,DE,13,7,6,1,1v1 Random Map
1972590,bobo,21453,976,FR,70,37,33,2,1v1 Random Map
1923441,Lauchaaaaaaaa,21455,976,AR,203,102,101,2,1v1 Random Map
1884505,Martini,21456,976,PL,11,5,6,0,1v1 Random Map
1852504,clement.tequi,21458,976,FR,109,55,54,1,1v1 Random Map
1581534,lars_kellner,21466,976,DE,124,63,61,6,1v1 Random Map
1440212,Gaia,21469,976,TR,27,10,17,0,1v1 Random Map
244723,GTR73,21494,975,FR,24,12,12,1,1v1 Random Map
1918009,Dinde_de_Choix,21518,975,FR,15,7,8,0,1v1 Random Map
1630949,CoyBlackout95,21527,975,AU,26,14,12,0,1v1 Random Map
1526440,Ratty,21530,975,AU,170,86,84,2,1v1 Random Map
2060301,Xoric,21584,974,ES,14,6,8,0,1v1 Random Map
2030448,Atza,21586,974,MX,70,36,34,0,1v1 Random Map
1489817,Your Best Nightmare,21604,974,AU,94,48,46,1,1v1 Random Map
889670,raphaeldu44,21622,973,FR,145,65,80,34,1v1 Random Map
768437,gaetan789,21625,973,FR,38,19,19,0,1v1 Random Map
718771,nuka-morphie,21626,973,TR,163,81,82,5,1v1 Random Map
515741,esnsy,21632,973,BG,14,6,8,0,1v1 Random Map
2264370,YungSharis,21643,973,CA,25,11,14,0,1v1 Random Map
1734449,ChromXXX,21672,973,NA,229,114,115,10,1v1 Random Map
1716902,Noblesse,21674,973,SG,21,9,12,0,1v1 Random Map
1489850,Balu,21681,973,DE,10,5,5,0,1v1 Random Map
1207372,Vx_EvOLuTioN_Xv,21694,973,AT,21,10,11,0,1v1 Random Map
887904,Failoh,21699,972,LU,275,140,135,5,1v1 Random Map
527240,SIMBJOSUE,21703,972,MX,170,84,86,11,1v1 Random Map
2351892,alexneosg,21716,972,ES,29,15,14,0,1v1 Random Map
2285477,mikimouse747,21719,972,TW,113,56,57,0,1v1 Random Map
1757125,alansmillis,21740,972,US,355,179,176,3,1v1 Random Map
1499701,School47,21749,972,RU,15,7,8,0,1v1 Random Map
293675,Waywardstone,21753,972,US,21,9,12,0,1v1 Random Map
303591,El CID,21828,971,US,344,173,171,5,1v1 Random Map
1108829,Mohamed Almorrana,21838,970,ES,40,18,22,3,1v1 Random Map
644257,_LorDaniel_,21851,970,HU,27,12,15,0,1v1 Random Map
1159659,David-sraam,21913,969,MX,39,20,19,1,1v1 Random Map
915284,Original AI,21917,969,GB,22,8,14,3,1v1 Random Map
619904,A Flying Nun,21922,969,DE,58,30,28,2,1v1 Random Map
2569299,Dumbhill,21937,969,TR,13,4,9,0,1v1 Random Map
2531010,robertmarin91,21938,969,ES,15,6,9,0,1v1 Random Map
2243402,TTVMystikPahndah,21947,969,AU,17,8,9,0,1v1 Random Map
2129379,X3st4,21951,969,ES,143,75,68,5,1v1 Random Map
2078521,Tomoki,21952,969,TW,218,107,111,2,1v1 Random Map
1959696,Juansvoleta,21958,969,CL,13,6,7,0,1v1 Random Map
1864384,neoweyss,21965,969,FR,21,10,11,0,1v1 Random Map
2076296,Bidderlyn,22034,968,IL,91,47,44,8,1v1 Random Map
1867293,rjeanniere,22048,968,FR,50,26,24,0,1v1 Random Map
1403368,Maul,22058,968,BR,121,61,60,3,1v1 Random Map
266744,ShadowDagger666,22072,967,AU,70,34,36,3,1v1 Random Map
2480372,HulsaSoso,22087,967,NA,11,5,6,0,1v1 Random Map
318012,Usidore the Blue,22123,967,US,67,35,32,15,1v1 Random Map
273169,SindonistiS,22133,966,GR,71,35,36,1,1v1 Random Map
1941012,spilling,22180,966,GB,144,73,71,2,1v1 Random Map
1109109,Ergonom,22205,965,FI,270,139,131,6,1v1 Random Map
901032,The Serge,22213,965,RO,16,7,9,0,1v1 Random Map
474768,Cappatita,22220,965,PE,270,135,135,3,1v1 Random Map
2688470,OptimalPillow,22223,965,US,19,8,11,0,1v1 Random Map
2383251,BayofDeath1,22235,965,US,31,14,17,0,1v1 Random Map
2113668,Ganiccus,22251,965,TR,48,24,24,0,1v1 Random Map
2060482,holysinner091,22253,965,NA,394,234,160,2,1v1 Random Map
1459452,hi im george,22268,965,HK,11,4,7,0,1v1 Random Map
1303681,Arroused,22272,965,GB,13,6,7,0,1v1 Random Map
829305,Knobscaper,22280,964,US,13,6,7,0,1v1 Random Map
513511,Me604ek,22291,964,RU,15,7,8,2,1v1 Random Map
497957,Amygdala Hijack,22294,964,DE,76,36,40,0,1v1 Random Map
2633133,la.suripanta,22296,964,AR,48,21,27,11,1v1 Random Map
2481092,GMURO,22303,964,MX,15,5,10,0,1v1 Random Map
2459913,TRNTH,22304,964,TW,18,8,10,1,1v1 Random Map
1892521,asaasa192,22327,964,TW,48,20,28,0,1v1 Random Map
1590810,Collossalthug,22332,964,US,86,46,40,1,1v1 Random Map
1082,Pellikka,22351,963,SE,20,9,11,0,1v1 Random Map
693170,kamphuis.alex,22360,963,NL,106,54,52,2,1v1 Random Map
597214,idefix,22363,963,FI,16,7,9,0,1v1 Random Map
2453806,CapitanTostado,22371,963,ES,46,22,24,0,1v1 Random Map
2132585,matrikar,22384,963,RU,106,50,56,4,1v1 Random Map
1218169,anmolmaly,22408,963,IN,516,258,258,36,1v1 Random Map
37294,Azka Chan,22418,962,CL,33,16,17,0,1v1 Random Map
2206591,Menino da porteira,22445,962,BR,14,6,8,0,1v1 Random Map
2078592,Jinshow,22451,962,AR,61,29,32,1,1v1 Random Map
1908739,freaKettOne,22458,962,NA,22,11,11,0,1v1 Random Map
1820853,Jaimeph,22463,962,CA,17,8,9,1,1v1 Random Map
1579791,Jacques Chirac,22473,962,FR,41,20,21,1,1v1 Random Map
1488270,itsuka,22475,962,CN,45,21,24,1,1v1 Random Map
1340141,hcombaz,22478,962,FR,19,9,10,0,1v1 Random Map
475048,The Majestic Thumb,22493,961,AU,11,3,8,0,1v1 Random Map
2164242,TomMariusNGX,22516,961,AU,17,8,9,0,1v1 Random Map
2025550,Dottore,22520,961,DE,39,19,20,0,1v1 Random Map
327157,doneil,22536,961,US,51,24,27,2,1v1 Random Map
1442041,TOFEUR26,22540,961,FR,10,3,7,0,1v1 Random Map
1023311,Wolfie,22549,960,CA,11,5,6,0,1v1 Random Map
2538649,Man_at_Farms,22572,960,CA,29,14,15,0,1v1 Random Map
2474207,FrostFurry,22574,960,LV,45,22,23,0,1v1 Random Map
1141845,getswole,22583,960,CA,30,13,17,0,1v1 Random Map
2250670,Parthumax,22584,960,AR,31,14,17,0,1v1 Random Map
1958512,Dusajs,22592,960,CZ,27,11,16,0,1v1 Random Map
1937220,Waylender,22596,960,FR,52,26,26,1,1v1 Random Map
1793184,KenyII,22601,960,RU,196,94,102,8,1v1 Random Map
312370,Cuauhpilli,22608,960,MX,381,191,190,19,1v1 Random Map
1484464,Tancrede,22609,960,NZ,183,94,89,3,1v1 Random Map
1447753,Theelesar,22610,960,TR,81,42,39,7,1v1 Random Map
1183437,FitzHerak,22618,960,NA,121,61,60,11,1v1 Random Map
644738,legia92,22630,959,BE,20,9,11,0,1v1 Random Map
2389374,sintezthegreat,22645,959,RU,174,87,87,0,1v1 Random Map
1870095,Paudie,22663,959,IE,66,33,33,3,1v1 Random Map
1409924,MindHandler,22672,959,US,274,139,135,0,1v1 Random Map
1186643,BlitzZerg,22676,959,ES,118,59,59,0,1v1 Random Map
268226,Unafano,22681,958,AR,119,60,59,11,1v1 Random Map
416315,Wall all lol  30,22701,958,PE,70,32,38,4,1v1 Random Map
2506228,Gocky on Twitch,22707,958,CA,11,4,7,0,1v1 Random Map
2496934,Pipor,22708,958,GB,29,15,14,0,1v1 Random Map
2105346,rpetice,22727,958,HU,56,28,28,0,1v1 Random Map
322166,单刷小飞侠,22748,958,CN,146,75,71,1,1v1 Random Map
1500402,branlopez,22754,958,ES,121,59,62,0,1v1 Random Map
1444832,[TPC]Hit the Luke,22756,958,DE,52,23,29,2,1v1 Random Map
1427589,ozankeremozcan12,22758,958,TR,14,6,8,0,1v1 Random Map
1348693,AdriánGG,22760,958,AR,173,86,87,1,1v1 Random Map
903526,Nicolasbis,22769,957,FR,647,326,321,4,1v1 Random Map
373131,Cinderella,22804,957,AT,49,21,28,2,1v1 Random Map
2046799,Somersetboy88,22812,957,GB,76,38,38,0,1v1 Random Map
1857374,leshazelryx,22823,957,FR,19,7,12,1,1v1 Random Map
659302,Tabanera,22853,956,ES,21,9,12,0,1v1 Random Map
458822,Surreal,22858,956,SE,36,17,19,0,1v1 Random Map
202755,piñaples,22875,956,CL,175,87,88,7,1v1 Random Map
2096430,Pitchoune,22877,956,BE,25,12,13,2,1v1 Random Map
1279521,Chambers,22900,956,AU,13,3,10,0,1v1 Random Map
1136813,Raiko,22904,955,FR,56,29,27,1,1v1 Random Map
1084661,MZ Wang,22908,955,US,14,6,8,0,1v1 Random Map
831607,Ac,22915,955,AU,32,15,17,0,1v1 Random Map
1829770,Looser,22950,955,CA,74,36,38,3,1v1 Random Map
1475193,Ben voyons !,22960,955,FR,87,44,43,8,1v1 Random Map
1014102,shadow_aspect91,22973,954,GB,103,51,52,1,1v1 Random Map
837474,albertgregory1992,22981,954,AU,12,4,8,1,1v1 Random Map
212426,Chacho,22983,954,ES,116,58,58,13,1v1 Random Map
622639,LordLuke13,22990,954,BR,72,37,35,7,1v1 Random Map
2317982,Hugetomb,23005,954,NA,104,51,53,0,1v1 Random Map
2268747,Richie Iannucci,23007,954,DE,19,9,10,0,1v1 Random Map
1944305,Hanlonomics,23019,954,US,30,14,16,0,1v1 Random Map
242729,plutochimaere50,23055,953,AR,22,9,13,2,1v1 Random Map
150211,Tauroxx23,23057,953,NA,145,73,72,4,1v1 Random Map
2154801,tommy <3,23081,953,DE,30,13,17,0,1v1 Random Map
130765,DICTATOR,23123,952,RU,189,96,93,21,1v1 Random Map
226646,D3vFlash,23125,952,DE,92,47,45,2,1v1 Random Map
2593424,Drunk Fat Guy,23128,952,TR,16,7,9,0,1v1 Random Map
2037023,Nativos,23145,952,CO,19,8,11,2,1v1 Random Map
1850218,ItsWhitePhoenix,23158,952,IR,22,11,11,6,1v1 Random Map
1751472,El Pinguiño,23163,952,NL,51,26,25,0,1v1 Random Map
1436445,Pillepalle,23171,952,NA,27,14,13,2,1v1 Random Map
267018,GzKernel,23186,951,ES,52,26,26,0,1v1 Random Map
160650,Arathorn II,23202,951,AR,12,2,10,1,1v1 Random Map
2368055,CoffeeGuru,23212,951,NO,11,4,7,0,1v1 Random Map
2155295,Vivi,23220,951,IN,17,8,9,0,1v1 Random Map
2096022,Sanglant,23223,951,FR,74,38,36,0,1v1 Random Map
1337206,Dundergubben,23245,951,SE,37,17,20,2,1v1 Random Map
1028509,CHUBBYXO,23252,950,GB,14,6,8,0,1v1 Random Map
719249,Hadramut,23258,950,DE,240,119,121,7,1v1 Random Map
2408979,Work Ethic,23275,950,US,26,12,14,0,1v1 Random Map
2273081,068,23280,950,US,26,11,15,0,1v1 Random Map
1999180,TheOlympusTitan,23282,950,CA,32,15,17,1,1v1 Random Map
1692279,Patuoxun,23292,950,FR,96,49,47,1,1v1 Random Map
218412,Phade,23295,950,AT,129,65,64,0,1v1 Random Map
760454,[Anvil] ManlyNotCute,23317,949,US,60,27,33,0,1v1 Random Map
523886,GaTTo,23322,949,BR,173,84,89,2,1v1 Random Map
2452820,Stgojavier,23341,949,CL,14,6,8,1,1v1 Random Map
1866884,duoble.2,23365,949,AR,61,30,31,0,1v1 Random Map
1779652,jeffisabelle,23367,949,TR,41,20,21,0,1v1 Random Map
2183511,AlloY,23418,948,US,65,32,33,1,1v1 Random Map
2026353,Iron Nyax,23423,948,NA,190,95,95,2,1v1 Random Map
1881728,Uncle Rico,23433,948,US,23,10,13,0,1v1 Random Map
2502339,F!r3-Scr3@m,23478,947,RO,17,7,10,0,1v1 Random Map
2450311,akiffgenc,23479,947,TR,11,2,9,1,1v1 Random Map
350220,Akgnor,23498,947,NL,26,12,14,2,1v1 Random Map
1417305,Senzu,23518,947,FR,34,17,17,1,1v1 Random Map
1353773,helispin,23523,947,AU,110,54,56,0,1v1 Random Map
1161564,Rhiiannon4525,23527,946,NA,10,4,6,0,1v1 Random Map
244364,mills and cookies,23541,946,GB,18,8,10,0,1v1 Random Map
452594,sEND3r,23546,946,SI,28,12,16,3,1v1 Random Map
2269463,squishyboo,23563,946,IT,104,52,52,1,1v1 Random Map
2115886,chiu_sze,23568,946,HK,11,5,6,1,1v1 Random Map
2040908,SuperNoodle,23579,946,CH,46,21,25,2,1v1 Random Map
299796,karlonx0_,23610,946,CL,24,7,17,0,1v1 Random Map
2537074,joaco,23640,945,UY,28,14,14,5,1v1 Random Map
2251003,CJW,23651,945,DE,12,4,8,0,1v1 Random Map
2094471,Pooclak,23654,945,CA,11,5,6,0,1v1 Random Map
1741844,Crewstian,23665,945,SE,13,5,8,0,1v1 Random Map
1283181,Papst Baldrian I,23676,945,DE,74,37,37,3,1v1 Random Map
1054260,RedChallengeR,23682,944,CA,19,7,12,0,1v1 Random Map
229381,Sven Forkbeard,23700,944,SE,150,76,74,2,1v1 Random Map
2428945,YamiSeiShin,23708,944,US,16,7,9,1,1v1 Random Map
2016509,FreddieMorecurry,23729,944,US,10,4,6,1,1v1 Random Map
1934152,manuelmoralesm10,23736,944,GT,23,9,14,1,1v1 Random Map
1683369,Luki,23743,944,AT,85,43,42,0,1v1 Random Map
578565,"Broseidon, Ruler of the Brocean",23776,943,CZ,50,23,27,0,1v1 Random Map
386741,je-reve-souvent,23795,943,FR,251,125,126,3,1v1 Random Map
2290563,The_Enigma,23805,943,AU,14,6,8,0,1v1 Random Map
2114432,vglCastro,23814,943,IT,131,63,68,3,1v1 Random Map
1923766,fjCAMO,23823,943,MX,14,8,6,0,1v1 Random Map
1686028,WizKeyAndCoffee,23830,943,DE,241,122,119,21,1v1 Random Map
1412186,Waylander,23844,943,FR,95,46,49,0,1v1 Random Map
705282,romankirjanov92,23871,942,RU,78,41,37,10,1v1 Random Map
2575852,Vin16,23887,942,DE,26,11,15,0,1v1 Random Map
387050,The Anarchist,23891,942,AU,60,29,31,0,1v1 Random Map
1995536,jaripdm,23910,942,DE,12,5,7,0,1v1 Random Map
1807405,Wilski,23916,942,NO,127,64,63,13,1v1 Random Map
1224711,Ayra191,23929,942,TR,205,105,100,1,1v1 Random Map
60593,yhcsurd,23937,941,US,58,31,27,7,1v1 Random Map
770496,WattledFerret53,23939,941,NA,568,283,285,25,1v1 Random Map
427965,Helink2003,23949,941,TW,137,67,70,2,1v1 Random Map
1882643,Feioso,23977,941,BR,10,4,6,0,1v1 Random Map
455041,king_leoncio,24012,940,GB,14,6,8,0,1v1 Random Map
2270406,guidofacce,24032,940,UY,13,5,8,5,1v1 Random Map
2009998,gachelin.thomas596,24043,940,FR,26,13,13,0,1v1 Random Map
1860907,Langda Tyagi,24055,940,FR,10,4,6,0,1v1 Random Map
1737675,side0oeffect,24060,940,IN,79,38,41,3,1v1 Random Map
1725813,sverre-hellem,24062,940,NO,12,3,9,5,1v1 Random Map
1299439,davemonty33,24068,940,GB,17,7,10,1,1v1 Random Map
1283457,rogerio,24069,940,CH,153,75,78,2,1v1 Random Map
537467,TigerKing,24077,939,DE,12,5,7,0,1v1 Random Map
2571475,Syn,24088,939,AU,70,33,37,0,1v1 Random Map
2474225,olorin,24094,939,TR,36,15,21,0,1v1 Random Map
458452,eduardoillidge,24181,938,CO,32,13,19,1,1v1 Random Map
2304480,mohamedkhamis89,24188,938,GB,10,4,6,0,1v1 Random Map
1150515,Sef Cass,24224,937,US,42,21,21,1,1v1 Random Map
2408585,carlitosgodoy90,24249,937,PY,14,6,8,0,1v1 Random Map
2407904,Chaplin,24250,937,CA,16,8,8,0,1v1 Random Map
380289,TheMonkeyPickler,24256,937,US,35,15,20,0,1v1 Random Map
365834,Tomahawk,24261,937,CH,22,9,13,2,1v1 Random Map
1853834,HuchoMiguel,24271,937,FR,57,30,27,0,1v1 Random Map
1769701,aoe2Master,24274,937,NA,242,122,120,6,1v1 Random Map
1640715,MergeVerts,24278,937,NA,105,50,55,9,1v1 Random Map
1245884,kimleonh,24289,937,DE,106,55,51,18,1v1 Random Map
104187,Aussie_CrocHunter,24295,936,AU,17,8,9,1,1v1 Random Map
697614,Crokien,24303,936,CO,17,5,12,0,1v1 Random Map
478545,JOSANKILL007,24310,936,NA,60,26,34,9,1v1 Random Map
432220,"Raymond, Prince of Antioch",24312,936,AU,20,10,10,0,1v1 Random Map
2371504,Thottolenghi,24329,936,GB,28,13,15,1,1v1 Random Map
2317458,König Klöti,24405,935,DE,13,5,8,0,1v1 Random Map
1177211,jans,24433,934,DE,13,6,7,4,1v1 Random Map
1109645,faubox,24438,934,CO,28,14,14,0,1v1 Random Map
1049551,CHAMPI-ATOMIK,24442,934,FR,93,47,46,1,1v1 Random Map
1986476,marved,24480,934,DE,121,60,61,5,1v1 Random Map
1887269,real terminator,24484,934,BE,47,23,24,0,1v1 Random Map
289232,bugout,24506,934,CA,199,99,100,6,1v1 Random Map
2432014,CaptainPlanet,24536,933,NZ,24,11,13,0,1v1 Random Map
2078830,EL COMANDANTE .Gamdom.com,24550,933,AR,39,18,21,2,1v1 Random Map
2023993,XxCoMmBuNkErxX,24555,933,NA,320,161,159,17,1v1 Random Map
668449,YouCanResignNow,24584,932,GB,23,9,14,0,1v1 Random Map
2379131,mrturtle,24605,932,GB,24,10,14,1,1v1 Random Map
2134282,TheMadDogXP,24612,932,NZ,16,5,11,0,1v1 Random Map
1872310,jimmy.35,24622,932,FR,145,71,74,1,1v1 Random Map
1304918,benedikt121212,24639,932,DE,27,11,16,0,1v1 Random Map
1171449,VendeurDePoudre,24641,931,NA,45,20,25,0,1v1 Random Map
807442,F4c4,24650,931,NA,28,14,14,3,1v1 Random Map
526957,Deep Fried Oreos,24660,931,US,78,42,36,1,1v1 Random Map
2646971,DarthGandalf,24669,931,NL,31,12,19,0,1v1 Random Map
2608388,gonza,24670,931,AR,41,19,22,0,1v1 Random Map
2436547,Gkhn,24677,931,TR,19,8,11,0,1v1 Random Map
2313242,LOL Champion,24683,931,CZ,17,7,10,0,1v1 Random Map
333080,Kaon,24705,931,DE,19,7,12,1,1v1 Random Map
263528,JeanMich,24728,930,FR,27,13,14,0,1v1 Random Map
2505390,konredus,24748,930,AR,12,5,7,0,1v1 Random Map
177790,witchdoctor,24749,930,DE,38,21,17,0,1v1 Random Map
2086335,mlanutr,24765,930,IT,91,45,46,1,1v1 Random Map
1939885,GG,24770,930,IL,52,26,26,0,1v1 Random Map
1935412,kugihsu,24771,930,NA,16,6,10,5,1v1 Random Map
217378,Coal_and_Timber,24788,930,CH,140,65,75,0,1v1 Random Map
1331760,wertykamil,24791,930,US,64,33,31,1,1v1 Random Map
796637,AJAXMANNIEE,24804,929,NL,56,25,31,1,1v1 Random Map
2018746,L1NN0,24828,929,AR,16,7,9,0,1v1 Random Map
1212411,Welleeeeh,24849,929,CO,116,58,58,4,1v1 Random Map
2645219,developersem,24876,928,TR,74,36,38,1,1v1 Random Map
2449042,RayVaugan,24885,928,AR,36,18,18,0,1v1 Random Map
1869063,alessandro.diroberto,24910,928,AE,109,58,51,5,1v1 Random Map
1815184,Misal,24911,928,TR,38,18,20,1,1v1 Random Map
279628,UnLimiteD,24924,927,AR,10,4,6,0,1v1 Random Map
732387,MadMike,24926,927,FR,237,118,119,1,1v1 Random Map
2581400,Janus,24947,927,FR,28,13,15,0,1v1 Random Map
2538874,kellycat,24948,927,AU,30,13,17,1,1v1 Random Map
2335947,miguel93011,24955,927,CO,128,63,65,4,1v1 Random Map
1172204,OffCreature7386,24996,926,NA,32,16,16,2,1v1 Random Map
279955,krayt5,24998,926,IT,27,11,16,0,1v1 Random Map
1043028,iBro,24999,926,DE,37,15,22,1,1v1 Random Map
445312,pzarola,25023,926,CA,305,153,152,3,1v1 Random Map
2484051,Zougouloukata docteur à distanc,25032,926,FR,49,24,25,1,1v1 Random Map
2206324,Cirdan,25039,926,AR,42,21,21,2,1v1 Random Map
1955385,Belowknee,25051,926,US,23,10,13,3,1v1 Random Map
1561598,Sylvain,25068,926,FR,74,30,44,0,1v1 Random Map
1452545,Nextarian,25072,926,NA,47,23,24,1,1v1 Random Map
1016744,Krog_Gar,25082,925,CH,20,9,11,0,1v1 Random Map
964623,Tunga,25086,925,TR,23,9,14,0,1v1 Random Map
815478,Butter,25089,925,DE,25,12,13,0,1v1 Random Map
489394,Maicel,25099,925,CH,26,13,13,0,1v1 Random Map
1326748,edmelenaveet,25148,925,FR,31,13,18,1,1v1 Random Map
664887,Wolfi,25163,924,DE,10,4,6,0,1v1 Random Map
2276782,jamaciadave1,25182,924,NA,150,76,74,5,1v1 Random Map
2241476,YeraoO,25183,924,NA,59,28,31,0,1v1 Random Map
1989513,Nobleza,25187,924,DK,10,4,6,0,1v1 Random Map
1943689,Shirojj,25189,924,UY,40,18,22,2,1v1 Random Map
1863015,野蠻,25195,924,HK,10,3,7,0,1v1 Random Map
1269122,Songistic | Cooper,25212,924,HU,27,10,17,1,1v1 Random Map
451033,Stankadin,25246,923,IT,10,4,6,1,1v1 Random Map
2104877,GdaFrekka,25270,923,CH,18,4,14,0,1v1 Random Map
2039047,struttnoddy,25272,923,GB,16,8,8,0,1v1 Random Map
1441823,twitch.tv/dreeze,25296,923,DE,78,40,38,2,1v1 Random Map
2111495,aframundo167,25348,922,AR,27,12,15,0,1v1 Random Map
1973677,Busk,25352,922,DK,51,20,31,0,1v1 Random Map
1927980,roulette,25355,922,TR,29,15,14,0,1v1 Random Map
827792,JLM_CONDOR,25385,921,MX,119,58,61,1,1v1 Random Map
764415,the wuiten from Hamme,25386,921,BE,608,305,303,5,1v1 Random Map
470242,MagnificentPieceO'Pig,25399,921,AR,21,8,13,0,1v1 Random Map
2570455,_warrior,25408,921,PR,148,70,78,2,1v1 Random Map
2443375,frodogann,25411,921,FR,13,5,8,0,1v1 Random Map
1980080,Aozeny,25430,921,FR,31,13,18,0,1v1 Random Map
1075206,k_cho46,25454,920,MX,327,164,163,11,1v1 Random Map
269589,Rickos,25460,920,FR,11,6,5,0,1v1 Random Map
840312,Weird Suport,25463,920,US,65,33,32,1,1v1 Random Map
2687081,wyszatkt,25477,920,CA,123,61,62,5,1v1 Random Map
1842187,/pantsyboy,25505,920,US,36,15,21,0,1v1 Random Map
2314288,^4[F.Y.N]^8EBR^8ONY,25539,919,GR,15,7,8,0,1v1 Random Map
1727695,Hebele,25557,919,TR,12,4,8,0,1v1 Random Map
303660,SurgeSplurge,25568,919,US,45,25,20,1,1v1 Random Map
1221936,sibohu,25574,919,ES,105,50,55,0,1v1 Random Map
584027,Sekuro,25587,918,DE,30,13,17,2,1v1 Random Map
2521538,trapito92,25604,918,AR,23,12,11,7,1v1 Random Map
2255611,Kenguan,25610,918,BE,81,34,47,1,1v1 Random Map
2096361,Dokkal,25614,918,FR,43,20,23,1,1v1 Random Map
1751745,Finn,25631,918,DE,10,3,7,1,1v1 Random Map
1293807,F,25644,918,BR,19,7,12,7,1v1 Random Map
815217,crushinator,25655,917,US,20,8,12,0,1v1 Random Map
616483,kagan_ant,25660,917,TR,45,19,26,0,1v1 Random Map
412845,925dami,25667,917,TW,62,28,34,1,1v1 Random Map
2140788,hoitloiftska,25689,917,DE,123,62,61,2,1v1 Random Map
1930068,bgen02 (son of kennyS),25701,917,FR,110,55,55,2,1v1 Random Map
1487205,Neaako,25711,917,FR,37,19,18,0,1v1 Random Map
1230459,stringdean,25719,917,US,22,9,13,3,1v1 Random Map
2612076,Seventh Child,25741,916,NZ,11,5,6,0,1v1 Random Map
2320296,RacsoRules,25750,916,MX,23,8,15,0,1v1 Random Map
2246744,JeremiasJero,25754,916,AR,80,42,38,0,1v1 Random Map
2207968,daWilliam,25758,916,DE,60,29,31,3,1v1 Random Map
2046265,Arrete de te branler va courir !,25769,916,FR,56,30,26,4,1v1 Random Map
2022211,Berky,25771,916,BE,25,12,13,0,1v1 Random Map
1881340,Sheep,25784,916,DE,28,12,16,0,1v1 Random Map
1728895,Tywin,25790,916,SE,40,22,18,0,1v1 Random Map
2234191,Chefen,25836,915,DK,25,11,14,0,1v1 Random Map
2228222,hitekk00,25838,915,HU,65,33,32,1,1v1 Random Map
2144428,Fasma,25842,915,CL,13,5,8,1,1v1 Random Map
2005910,gerleven,25848,915,AR,10,3,7,0,1v1 Random Map
1703845,Shibobo22,25864,915,NA,36,17,19,1,1v1 Random Map
1046438,waleuska2234,25879,914,US,130,66,64,1,1v1 Random Map
944861,BarringSanta,25882,914,SE,50,27,23,1,1v1 Random Map
2209759,Impubere,25911,914,GB,29,13,16,0,1v1 Random Map
1992548,Gambadou,25922,914,FR,13,5,8,0,1v1 Random Map
1981581,Veliuswiegraf,25925,914,NA,16,4,12,0,1v1 Random Map
1942530,p3ibol,25928,914,ES,14,6,8,0,1v1 Random Map
1853749,mannygcg,25931,914,AU,14,5,9,0,1v1 Random Map
535866,chalker,25964,913,BR,16,7,9,0,1v1 Random Map
87378,birabizah,25965,913,DE,10,4,6,0,1v1 Random Map
2529463,Nyxolas Cage,25974,913,DK,31,13,18,0,1v1 Random Map
366793,Alésiæ,25980,913,FR,59,29,30,1,1v1 Random Map
2309696,Cr@zy_RuLo,25981,913,ES,11,4,7,0,1v1 Random Map
1562020,Sentre47680,26010,913,NA,10,4,6,0,1v1 Random Map
1314026,Autopumpe,26018,913,DE,50,25,25,0,1v1 Random Map
290372,pintonium,26019,913,US,10,4,6,0,1v1 Random Map
394324,lordmwa,26044,912,GB,93,45,48,1,1v1 Random Map
1410238,Zoellick.-,26083,912,CL,41,18,23,2,1v1 Random Map
1266261,Wooden Trebuchet,26088,912,IN,129,65,64,14,1v1 Random Map
1111302,BOBARIUS3153,26089,912,NA,13,5,8,2,1v1 Random Map
876893,Timmay,26100,911,DE,65,32,33,1,1v1 Random Map
466481,diegogobellog,26109,911,NA,27,13,14,4,1v1 Random Map
2194543,MrBedtimeJr,26122,911,AU,61,28,33,0,1v1 Random Map
2193254,L'Orso di Civezzano,26123,911,IT,22,8,14,0,1v1 Random Map
853417,Jogginforcancer,26132,911,US,355,177,178,2,1v1 Random Map
1776259,WARLORD,26141,911,US,22,8,14,0,1v1 Random Map
2307945,eldurazno,26184,910,CL,31,14,17,1,1v1 Random Map
2219065,petersmithofasu,26188,910,US,55,26,29,0,1v1 Random Map
1382159,Calyst,26205,910,FR,256,130,126,12,1v1 Random Map
937426,Blueage,26215,909,AU,11,4,7,0,1v1 Random Map
105698,Sofia♥️LoveDarkness,26225,909,PE,166,82,84,2,1v1 Random Map
569411,LuckYLuke2401,26226,909,DE,185,93,92,20,1v1 Random Map
481129,Dimmy307,26228,909,AU,113,56,57,2,1v1 Random Map
2026379,Warownia,26250,909,NA,150,75,75,9,1v1 Random Map
1122715,goku.exe,26278,908,IN,99,51,48,2,1v1 Random Map
249541,MaNueL GaLLeGo,26288,908,ES,58,25,33,2,1v1 Random Map
647282,vinisilva06,26289,908,US,40,17,23,2,1v1 Random Map
2217027,jr.silos,26324,908,MX,76,37,39,5,1v1 Random Map
2056436,LucaNs27,26329,908,NA,119,57,62,1,1v1 Random Map
1635427,Joonfour,26335,908,FI,36,15,21,1,1v1 Random Map
1631443,[FAT] in the [HIKO],26336,908,US,42,19,23,0,1v1 Random Map
2473568,Solid Nate,26364,907,US,23,10,13,0,1v1 Random Map
2012929,meugeniara,26386,907,AR,19,8,11,0,1v1 Random Map
1997244,fernando.j.apaz,26387,907,AR,11,4,7,1,1v1 Random Map
1134266,MilouzZ_In the sky,26407,906,FR,26,12,14,0,1v1 Random Map
793841,Racer,26417,906,US,29,13,16,7,1v1 Random Map
717866,Bloodman,26420,906,FR,41,18,23,1,1v1 Random Map
608877,gerac89,26426,906,PA,69,35,34,1,1v1 Random Map
2673312,Nefro,26433,906,GE,40,15,25,2,1v1 Random Map
2089699,COVID-20,26447,906,US,52,26,26,3,1v1 Random Map
990391,dave6102,26477,905,US,333,167,166,33,1v1 Random Map
846699,levjoe,26481,905,CA,44,20,24,1,1v1 Random Map
739992,felipeaffc,26483,905,BR,28,14,14,12,1v1 Random Map
483396,Takeshi Kovacs,26488,905,CL,44,20,24,0,1v1 Random Map
2685254,II Corbo II,26492,905,CA,15,6,9,0,1v1 Random Map
2649484,"чё, хавать будешь?",26493,905,RU,17,7,10,0,1v1 Random Map
396143,sergio_sg87,26496,905,ES,27,10,17,0,1v1 Random Map
2504823,schlopod,26501,905,US,10,4,6,2,1v1 Random Map
2240809,jamba,26506,905,US,76,36,40,2,1v1 Random Map
2203836,Mr Emperor8541,26509,905,NA,50,23,27,0,1v1 Random Map
2179557,CockSpanker2000,26511,905,US,152,75,77,1,1v1 Random Map
595532,wetim5566,26552,904,AR,42,19,23,0,1v1 Random Map
2748022,Reo_月小凜,26558,904,TW,14,5,9,2,1v1 Random Map
2337681,JerboX7683,26573,904,NA,17,6,11,0,1v1 Random Map
374692,Sheogorath,26575,904,DE,30,12,18,0,1v1 Random Map
2079292,Bukki,26585,904,DE,32,13,19,1,1v1 Random Map
1564520,Deku,26604,904,FR,10,4,6,0,1v1 Random Map
1164585,Apheo,26618,903,CZ,40,18,22,1,1v1 Random Map
924389,Wausz,26621,903,NL,227,113,114,1,1v1 Random Map
2610777,OffCentred85,26630,903,NA,30,11,19,0,1v1 Random Map
2315762,AndreB.,26646,903,DE,196,98,98,7,1v1 Random Map
2239832,Kiwok,26650,903,AR,32,13,19,0,1v1 Random Map
2119156,Joff Rage,26659,903,NA,37,17,20,2,1v1 Random Map
330259,DerBonus,26669,903,DE,12,5,7,0,1v1 Random Map
1690232,Dose,26672,903,DE,16,7,9,0,1v1 Random Map
1519728,GregsKakadu,26678,903,DE,15,7,8,0,1v1 Random Map
1437358,Censach,26679,903,RU,72,35,37,4,1v1 Random Map
1291878,Hero,26684,903,US,267,135,132,3,1v1 Random Map
2451658,Luoar,26708,902,NA,26,12,14,0,1v1 Random Map
2341717,sanjay8,26711,902,AU,22,9,13,2,1v1 Random Map
1679749,a.noriegap88,26732,902,PE,26,12,14,0,1v1 Random Map
1635165,faNaS,26736,902,DE,49,23,26,0,1v1 Random Map
583418,Kvothe,26827,900,AR,22,9,13,0,1v1 Random Map
2264386,Yetkili Bey,26846,900,TR,11,5,6,0,1v1 Random Map
2130870,PaRaDiZze Yz,26855,900,NA,10,3,7,0,1v1 Random Map
1685587,Ynghlingar,26870,900,IT,27,12,15,1,1v1 Random Map
1523379,starzrc,26875,900,US,39,16,23,0,1v1 Random Map
1172347,keith.garfield,26885,899,US,34,16,18,0,1v1 Random Map
1108495,Titien62,26886,899,FR,42,19,23,1,1v1 Random Map
1833550,MoNoPoLaR74,26938,899,NA,24,10,14,1,1v1 Random Map
1551220,Shòt,26946,899,FR,10,3,7,0,1v1 Random Map
1501088,Ic4fruit,26949,899,DE,25,10,15,0,1v1 Random Map
248252,Ragoo,26963,898,ZA,33,14,19,1,1v1 Random Map
410565,Crazy Penguin,26971,898,AU,155,77,78,5,1v1 Random Map
2429028,ErvynKhan,26978,898,FR,13,5,8,0,1v1 Random Map
2286659,Kongbu,26984,898,FR,22,9,13,0,1v1 Random Map
2020461,vto_89,26998,898,ES,70,33,37,5,1v1 Random Map
1474252,vnct,27016,898,FR,250,125,125,31,1v1 Random Map
669535,wangzhongjia,27032,897,CN,69,30,39,0,1v1 Random Map
533802,豬頭我的車咧!?,27036,897,TW,171,88,83,8,1v1 Random Map
2574995,Abb4don,27041,897,AR,19,9,10,0,1v1 Random Map
2334269,DAAAAAAAAAAMN,27047,897,GR,13,5,8,1,1v1 Random Map
1884340,Miguelitolón,27060,897,ES,11,3,8,0,1v1 Random Map
960120,Mallus Popallus,27084,896,DE,99,47,52,0,1v1 Random Map
498570,GRAND AZTEC FORTIFICATIONS,27095,896,RU,17,7,10,0,1v1 Random Map
2366010,micheleconti96,27116,896,IT,34,14,20,0,1v1 Random Map
2085100,圆了,27122,896,CN,19,8,11,0,1v1 Random Map
2030871,ricardosilva.juridico,27126,896,BR,16,6,10,0,1v1 Random Map
1879727,Mauruss,27131,896,IT,12,2,10,1,1v1 Random Map
534108,Deaca0,27161,895,DE,23,10,13,0,1v1 Random Map
2135970,TheConquero,27183,895,PE,10,2,8,0,1v1 Random Map
2025336,A,27192,895,BR,23,8,15,0,1v1 Random Map
1671554,Laffranchizi,27204,895,FR,68,35,33,1,1v1 Random Map
1258939,WonessaTV,27213,895,ES,25,10,15,0,1v1 Random Map
914175,KingTim,27221,894,US,35,14,21,0,1v1 Random Map
2465153,eliteDVN3842,27236,894,NA,13,5,8,0,1v1 Random Map
2225772,jl,27249,894,ES,40,18,22,0,1v1 Random Map
1990202,GOOLFYZERA,27255,894,BR,38,16,22,3,1v1 Random Map
1895235,MisterRedBeans,27262,894,NZ,225,113,112,0,1v1 Random Map
479048,Gabriela Cerruti,27292,893,AR,31,14,17,0,1v1 Random Map
2602900,daniel,27301,893,SE,11,4,7,0,1v1 Random Map
2412114,aaron.foster3,27308,893,GB,11,4,7,0,1v1 Random Map
2373750,Xerxes,27311,893,CA,117,59,58,0,1v1 Random Map
2106909,tomateiro7409,27319,893,NA,42,20,22,3,1v1 Random Map
1955776,damarc,27325,893,AR,32,14,18,0,1v1 Random Map
2056672,DiAngeli90,27386,892,BR,11,4,7,0,1v1 Random Map
1769328,Cpt_Ragequote,27396,892,DE,111,58,53,0,1v1 Random Map
1496069,Nico le conquer,27401,892,FR,27,9,18,0,1v1 Random Map
1350429,Karnack1748,27404,892,NA,49,23,26,0,1v1 Random Map
1338576,Horizon,27405,892,NO,19,7,12,0,1v1 Random Map
2332454,johannes.marynissen,27434,891,BE,60,27,33,1,1v1 Random Map
2268108,StevenSeagull,27436,891,DE,20,8,12,0,1v1 Random Map
1417645,C.Baptist,27463,891,DE,48,23,25,1,1v1 Random Map
1386043,xaleate,27464,891,AU,38,16,22,0,1v1 Random Map
586517,The_Bias_King,27475,890,AU,88,41,47,1,1v1 Random Map
2301633,Mackpein,27493,890,IT,19,7,12,0,1v1 Random Map
1936001,guigui_3589,27506,890,FR,142,70,72,3,1v1 Random Map
1802285,erwan.duv34,27510,890,FR,31,12,19,2,1v1 Random Map
1378045,Earl G of AOE,27521,890,AU,78,38,40,2,1v1 Random Map
1327475,taN,27524,890,GB,176,87,89,0,1v1 Random Map
781676,hugovenez,27543,889,MX,34,14,20,1,1v1 Random Map
731915,mark.santolucito,27546,889,US,11,3,8,0,1v1 Random Map
2611526,Obikaii,27557,889,AU,11,4,7,0,1v1 Random Map
380175,tb2r,27567,889,FR,262,130,132,6,1v1 Random Map
2114777,Suanagan,27583,889,ES,15,5,10,0,1v1 Random Map
2597211,DimaRzy,27632,888,PL,25,11,14,2,1v1 Random Map
2522474,Häuptling Quack Quack,27636,888,DE,22,8,14,0,1v1 Random Map
2319307,Sandwar8920,27643,888,NA,35,19,16,1,1v1 Random Map
1946778,Dragongoblin,27652,888,AU,10,4,6,1,1v1 Random Map
1806466,perfektionist77,27653,888,DE,123,61,62,7,1v1 Random Map
1159412,justLu,27672,887,DE,14,6,8,1,1v1 Random Map
2520838,JeCuMu,27694,887,ES,69,33,36,3,1v1 Random Map
2337755,alejandrobarrios07,27698,887,UY,67,36,31,1,1v1 Random Map
2114572,Antiquity,27707,887,US,33,14,19,0,1v1 Random Map
1989553,baneden77,27712,887,US,19,8,11,0,1v1 Random Map
1222289,Knallgas M.A.,27723,887,DE,77,36,41,0,1v1 Random Map
2014710,CacıkYiyenZombi,27754,886,TR,19,6,13,0,1v1 Random Map
1918244,aymen,27757,886,DE,318,159,159,19,1v1 Random Map
306538,Josetsy,27772,886,CL,200,99,101,9,1v1 Random Map
787267,Beefallo,27790,885,IN,70,35,35,1,1v1 Random Map
1767012,KaiZerShift,27833,885,FR,47,24,23,0,1v1 Random Map
1741700,MimosaDankness,27835,885,NA,29,14,15,2,1v1 Random Map
2464293,thalasa,27862,884,US,14,5,9,1,1v1 Random Map
2163899,帝国种粮大户,27873,884,CN,161,81,80,2,1v1 Random Map
1875409,Lerri d'Arabia,27879,884,IT,16,5,11,0,1v1 Random Map
1603818,manned wolf,27887,884,US,58,26,32,0,1v1 Random Map
1197882,BUZZARD,27898,884,AU,41,19,22,2,1v1 Random Map
2478639,RBSandoval,27918,883,MX,69,33,36,1,1v1 Random Map
2103861,spirosklp,27931,883,GR,26,10,16,0,1v1 Random Map
1913519,whosayin,27941,883,TR,57,31,26,0,1v1 Random Map
1719505,Towers,27945,883,DK,328,167,161,4,1v1 Random Map
1700338,holycow,27998,882,FR,12,4,8,0,1v1 Random Map
1528267,xennonx,28001,882,DE,11,4,7,0,1v1 Random Map
733103,SwaggerOnAZillion101,28018,881,AT,54,25,29,3,1v1 Random Map
1882129,FoxyFears,28053,881,US,168,84,84,1,1v1 Random Map
1737935,UberJukeD,28060,881,AU,21,9,12,0,1v1 Random Map
1945580,Travesty,28113,880,US,15,5,10,0,1v1 Random Map
1926865,ajklump24,28115,880,US,10,4,6,0,1v1 Random Map
1214902,Chris Hansen,28137,880,CA,255,127,128,8,1v1 Random Map
2433316,wayh,28153,879,CN,232,115,117,5,1v1 Random Map
1130107,juan.novo,28188,878,AR,186,93,93,14,1v1 Random Map
1124546,GravierRose2877,28189,878,NA,14,5,9,0,1v1 Random Map
2511784,IgoCQuoiLesBails,28207,878,FR,78,38,40,3,1v1 Random Map
2369882,yaramazkarga,28211,878,TR,50,24,26,0,1v1 Random Map
2218578,LuckyMcClellan,28217,878,US,23,10,13,0,1v1 Random Map
1526250,Gunther,28235,878,AU,22,10,12,0,1v1 Random Map
1500829,Borjagronka,28237,878,ES,32,14,18,0,1v1 Random Map
85080,Lorenz051,28254,877,FR,24,11,13,1,1v1 Random Map
549275,Exponentielles Wachstum,28255,877,DE,345,173,172,3,1v1 Random Map
2653822,DavidVJ18,28256,877,NA,46,20,26,1,1v1 Random Map
2314603,enrique_pinillos,28271,877,ES,50,23,27,3,1v1 Random Map
2024813,EazyT,28282,877,FR,17,7,10,0,1v1 Random Map
1933371,Runaway Turtle,28287,877,US,22,9,13,3,1v1 Random Map
1462604,Rex,28304,877,IE,108,53,55,1,1v1 Random Map
1430421,Sonnegod Sadboy,28306,877,US,25,10,15,1,1v1 Random Map
742640,dvlopez41,28324,876,HN,22,8,14,0,1v1 Random Map
2650558,Ever,28328,876,AR,40,17,23,0,1v1 Random Map
2622851,anthonykrafft7,28332,876,US,11,3,8,0,1v1 Random Map
2250195,Kuken,28342,876,SE,12,5,7,0,1v1 Random Map
2008007,gijsnoordam,28400,875,NL,76,35,41,0,1v1 Random Map
1797941,sherryindahouse,28413,875,IE,129,63,66,3,1v1 Random Map
2686258,omostertman,28447,874,NL,94,47,47,0,1v1 Random Map
2555806,mr.reese,28449,874,TR,88,47,41,3,1v1 Random Map
2137412,s0j4,28461,874,AR,56,26,30,1,1v1 Random Map
2001850,MunroWarrior,28467,874,AR,25,12,13,0,1v1 Random Map
1846610,TuNichtSo,28472,874,DE,12,4,8,0,1v1 Random Map
57429,Dan1elx99,28482,874,NA,80,37,43,2,1v1 Random Map
1262599,or.llanos,28485,874,MX,46,20,26,0,1v1 Random Map
913388,hakanxwolf,28493,873,TR,298,149,149,3,1v1 Random Map
1860446,Conka,28526,873,TR,152,76,76,7,1v1 Random Map
265793,LogyFromEarth,28543,872,GB,37,18,19,1,1v1 Random Map
235974,mattiegamer,28550,872,NL,43,20,23,0,1v1 Random Map
399083,Smash,28557,872,US,16,6,10,0,1v1 Random Map
2575606,AAA,28558,872,TR,49,23,26,0,1v1 Random Map
2400360,Danny_93,28562,872,GB,69,35,34,3,1v1 Random Map
2230885,theguiltyparty,28569,872,GB,25,11,14,0,1v1 Random Map
2018089,Rehf Dogg,28587,872,US,20,8,12,0,1v1 Random Map
1838344,WhatIsThis,28593,872,US,76,35,41,0,1v1 Random Map
1838112,Kolorikeen,28594,872,FR,28,13,15,0,1v1 Random Map
1206277,OfficerBLT,28608,872,US,11,3,8,0,1v1 Random Map
998594,asmithg91,28613,871,NA,21,8,13,2,1v1 Random Map
2298340,Munkix,28645,871,US,28,12,16,1,1v1 Random Map
2137293,Cizna,28651,871,MX,85,44,41,3,1v1 Random Map
1779481,2baker7,28664,871,ES,44,22,22,1,1v1 Random Map
2563958,Phillron,28735,869,SE,25,9,16,0,1v1 Random Map
2159202,matthewswilcox,28747,869,US,14,5,9,0,1v1 Random Map
336551,Crixus,28764,869,IN,28,12,16,1,1v1 Random Map
861763,A.SkywalkeR,28777,868,ES,15,3,12,0,1v1 Random Map
835090,warwarina,28779,868,DE,34,15,19,1,1v1 Random Map
2552692,BrettSheeran,28790,868,DE,31,13,18,0,1v1 Random Map
2402115,ricovandegevel,28795,868,NL,31,13,18,1,1v1 Random Map
2070478,Doud,28803,868,FR,39,18,21,0,1v1 Random Map
1953918,wzd27,28807,868,DE,18,7,11,0,1v1 Random Map
1585588,AonGA,28817,868,NA,109,48,61,17,1v1 Random Map
1446391,LupusLobo,28818,868,AR,369,182,187,5,1v1 Random Map
1007890,AlexNavas,28829,867,DE,181,90,91,3,1v1 Random Map
797146,Didzzz§!,28833,867,FR,137,65,72,1,1v1 Random Map
2409938,YARRR!!!,28843,867,US,11,0,11,0,1v1 Random Map
2313718,Vekerekel,28851,867,AR,31,13,18,1,1v1 Random Map
1691722,Henne,28878,867,DE,61,25,36,0,1v1 Random Map
1130450,starstone86rip,28889,866,FR,26,10,16,1,1v1 Random Map
786107,Bloodex,28903,866,DE,51,24,27,1,1v1 Random Map
679536,illid44n1,28908,866,NA,10,4,6,0,1v1 Random Map
557349,Dia Kurosawa,28911,866,CL,53,25,28,0,1v1 Random Map
2316153,ChrisLee1609,28923,866,NA,35,17,18,3,1v1 Random Map
1880250,IAmOneWithTheForce,28937,866,AT,29,11,18,0,1v1 Random Map
1207763,mixas,28950,866,PE,151,74,77,5,1v1 Random Map
2521150,FELIX_ALASTOR,28978,865,ES,29,12,17,0,1v1 Random Map
1977655,Cacu Cesa,29000,865,AR,13,4,9,1,1v1 Random Map
1468292,Toudodo,29008,865,FR,24,11,13,2,1v1 Random Map
2298134,KingMoore,29023,864,AR,10,3,7,0,1v1 Random Map
1085060,neWWel,29046,864,DE,187,91,96,0,1v1 Random Map
2656245,Gustavo Fring,29063,863,GB,10,3,7,0,1v1 Random Map
2030679,ChApi,29088,863,AR,24,7,17,2,1v1 Random Map
1979880,priecan,29091,863,ES,25,12,13,0,1v1 Random Map
315842,ジェフリー MrNiceGuy32,29101,863,US,38,17,21,6,1v1 Random Map
2517294,pessimistic,29124,862,JP,153,75,78,3,1v1 Random Map
2353329,Ins.Nh_ShAgY,29130,862,EC,14,6,8,0,1v1 Random Map
2030308,LOKI-notdead,29141,862,AR,81,39,42,0,1v1 Random Map
329760,Sylen,29153,862,AU,23,8,15,2,1v1 Random Map
470566,jonahanderson12,29222,860,US,14,2,12,0,1v1 Random Map
2115458,TigreDeAnillaco,29244,860,AR,20,8,12,0,1v1 Random Map
2101509,Fawltea,29245,860,GB,20,8,12,0,1v1 Random Map
1921720,cackyroche,29252,860,US,66,33,33,0,1v1 Random Map
1887918,Swagfag comeback,29253,860,NO,63,30,33,8,1v1 Random Map
1554594,LokiBrutalo9677,29260,860,NA,225,109,116,11,1v1 Random Map
1395873,nutellamaniac,29264,860,AU,501,243,258,9,1v1 Random Map
1038603,123,29269,859,CZ,20,8,12,0,1v1 Random Map
246967,Iduzhii,29275,859,RU,11,4,7,5,1v1 Random Map
2403863,sim321,29288,859,GB,44,19,25,0,1v1 Random Map
1892974,Crispy Fish,29308,859,US,10,3,7,0,1v1 Random Map
1637581,s.phillips_,29315,859,GB,22,9,13,0,1v1 Random Map
1898776,i_love_beer,29361,858,DE,63,30,33,1,1v1 Random Map
1726465,Benai,29367,858,BR,104,50,54,0,1v1 Random Map
1685472,mattscarlett8,29368,858,GB,11,3,8,0,1v1 Random Map
513046,clementixlegaullois,29388,857,FR,12,5,7,0,1v1 Random Map
474214,Lord Thanos,29389,857,US,174,87,87,12,1v1 Random Map
2666160,TigerShark,29390,857,IN,15,5,10,0,1v1 Random Map
1468962,DuckHeist,29428,857,DE,57,28,29,2,1v1 Random Map
1453987,Alcyon,29429,857,FR,24,10,14,0,1v1 Random Map
300207,El Fuerto Sabio,29430,857,US,12,2,10,0,1v1 Random Map
274457,Sapa Inka,29435,856,PE,216,106,110,12,1v1 Random Map
206949,jokerino,29440,856,AU,55,26,29,4,1v1 Random Map
2515593,viagem perdida,29452,856,BR,18,8,10,0,1v1 Random Map
224583,jcbreda,29460,856,BR,184,88,96,6,1v1 Random Map
1963991,jeanbaptiste.delaporte,29478,856,FR,13,4,9,0,1v1 Random Map
347099,Qaledor,29479,856,ES,216,107,109,6,1v1 Random Map
2683445,Кализо,29514,855,AR,12,3,9,0,1v1 Random Map
2267898,esanders319,29529,855,US,58,25,33,10,1v1 Random Map
2114868,lukedls,29537,855,GB,20,8,12,0,1v1 Random Map
4511,Hadiraja12,29551,855,NA,65,30,35,1,1v1 Random Map
1566100,MoDMishkin,29554,855,GB,52,23,29,4,1v1 Random Map
2512726,Axel PR1ME,29574,854,ES,10,3,7,0,1v1 Random Map
2356662,Vincitore7,29578,854,NL,74,35,39,1,1v1 Random Map
2277947,Vincent1n,29581,854,GB,28,9,19,0,1v1 Random Map
2243936,Prodigy R,29583,854,US,14,5,9,0,1v1 Random Map
1554107,PacoDaLucia,29652,853,NL,10,3,7,1,1v1 Random Map
971513,红鲤鱼与驴,29663,852,CN,29,11,18,1,1v1 Random Map
2515323,EVIL PAPAGALI ;,29683,852,BR,33,18,15,0,1v1 Random Map
2013329,alpinoeisbaer,29697,852,AT,135,68,67,1,1v1 Random Map
1680790,ChuckDeezy,29710,852,US,17,7,10,0,1v1 Random Map
1475211,Bastard,29714,852,NL,95,48,47,2,1v1 Random Map
964500,oscarastatw,29726,851,TW,79,35,44,2,1v1 Random Map
570591,N.S.M,29734,851,CN,58,26,32,3,1v1 Random Map
2329057,Honey & Nick,29754,851,NZ,16,6,10,0,1v1 Random Map
1320149,harsh.uke,29782,851,IN,22,6,16,1,1v1 Random Map
1247911,cpmcarlinda,29784,851,ES,36,13,23,2,1v1 Random Map
1787851,turu,29829,850,FI,20,8,12,0,1v1 Random Map
1024651,Loconandi,29847,849,CL,41,19,22,1,1v1 Random Map
2390254,Benificent,29922,848,US,15,5,10,1,1v1 Random Map
1894184,sanojrehtlaw,29943,848,DE,21,8,13,0,1v1 Random Map
1314144,neiney,29960,848,FR,15,5,10,0,1v1 Random Map
2402341,pommepoco44,29980,847,FR,11,3,8,0,1v1 Random Map
2276277,PKP76,29983,847,FR,12,2,10,0,1v1 Random Map
1984545,Blenzed,29992,847,US,16,5,11,0,1v1 Random Map
1937066,bhaijaan,29996,847,GB,13,4,9,1,1v1 Random Map
993048,Akeron,30030,846,FR,80,38,42,0,1v1 Random Map
422815,Fëanor,30043,846,US,27,12,15,0,1v1 Random Map
2521399,Atin,30050,846,GB,11,3,8,0,1v1 Random Map
1612937,Ansgar,30075,846,DE,55,25,30,1,1v1 Random Map
622742,GreenFire711,30087,845,DE,21,8,13,0,1v1 Random Map
1949449,Provencal le Gaulois,30128,845,FR,12,2,10,0,1v1 Random Map
1711315,Yen House,30136,845,TW,70,29,41,1,1v1 Random Map
309814,RedBaronV,30140,845,MX,36,15,21,5,1v1 Random Map
2681640,kirlisakal,30158,844,TR,20,8,12,0,1v1 Random Map
2594064,Neville Bartos,30161,844,AU,16,6,10,0,1v1 Random Map
1903199,MONGOLÅYD,30185,844,NO,51,22,29,0,1v1 Random Map
1815280,GIS Prof,30188,844,DE,25,9,16,1,1v1 Random Map
2439895,dalessandropatricio,30228,843,AR,40,16,24,0,1v1 Random Map
2412527,voltapette,30229,843,FR,45,19,26,0,1v1 Random Map
276486,thedocspbn,30253,842,RO,34,12,22,1,1v1 Random Map
2481555,MeshUp134,30273,842,NA,24,10,14,0,1v1 Random Map
2320486,^4Master ^3of ^2RKO,30279,842,DE,84,37,47,1,1v1 Random Map
2275144,TGlitch,30283,842,AT,62,30,32,0,1v1 Random Map
2185575,raynor11,30285,842,US,43,18,25,0,1v1 Random Map
466296,leutzsch-1964,30320,841,DE,67,33,34,2,1v1 Random Map
1389156,blue_scare.FR,30358,841,FR,325,161,164,6,1v1 Random Map
588174,LiSis,30373,840,US,184,90,94,1,1v1 Random Map
1878053,cherryeg,30406,840,US,67,31,36,2,1v1 Random Map
738957,Minecraft Melons,30434,839,US,30,15,15,3,1v1 Random Map
2064265,brock.bettilyon,30457,839,US,11,4,7,0,1v1 Random Map
1740850,hogergo,30463,839,HU,65,30,35,1,1v1 Random Map
696898,luifer_nov,30482,838,DE,110,49,61,2,1v1 Random Map
527974,ShinyShaman,30489,838,CA,59,26,33,0,1v1 Random Map
2425362,Tu7e,30500,838,AR,13,5,8,3,1v1 Random Map
1946560,Joker0848111,30518,838,NA,36,18,18,0,1v1 Random Map
1517989,Stan444,30534,838,FR,22,9,13,1,1v1 Random Map
1564086,Starbuck,30552,837,ZA,63,30,33,2,1v1 Random Map
2366565,Dr.Ö,30565,837,DE,95,46,49,1,1v1 Random Map
379382,Pink Locomotive,30566,837,GB,264,129,135,6,1v1 Random Map
2359553,Bear_Stick,30567,837,US,44,17,27,1,1v1 Random Map
2047228,Kap_tainn,30574,837,FR,14,5,9,2,1v1 Random Map
149183,Champaqui,30584,837,PE,281,135,146,13,1v1 Random Map
2217256,vizcaino19,30607,836,MX,58,26,32,4,1v1 Random Map
1197911,Maxou4563,30636,836,NA,10,3,7,0,1v1 Random Map
2278865,thoscar4,30667,835,FR,48,22,26,2,1v1 Random Map
2144780,Michael Lewis,30672,835,FR,50,23,27,0,1v1 Random Map
1170217,raquet,30685,834,FR,98,47,51,3,1v1 Random Map
551621,BaC,30700,834,CH,72,36,36,0,1v1 Random Map
2432868,AboutDragon8748,30708,834,NA,14,4,10,0,1v1 Random Map
986768,StarDrux,30737,833,PT,81,38,43,5,1v1 Random Map
231837,[NVVM]Oolo,30748,833,DE,61,26,35,2,1v1 Random Map
171951,Bielson,30801,832,ES,172,86,86,11,1v1 Random Map
1075433,Overlord,30806,832,MX,13,4,9,1,1v1 Random Map
2583795,LeOwNs_,30807,832,BR,14,1,13,0,1v1 Random Map
2540432,BarnsM&M's,30809,832,FR,20,7,13,0,1v1 Random Map
2442267,luke-d,30812,832,DE,28,10,18,0,1v1 Random Map
2359982,Bigorneau,30815,832,FR,14,5,9,0,1v1 Random Map
2503323,Ace_General,30861,831,US,18,6,12,1,1v1 Random Map
782391,javi123321,30899,830,PE,54,23,31,1,1v1 Random Map
2456080,Odino,30912,830,IT,76,35,41,1,1v1 Random Map
2397629,Julio The Sparrow,30914,830,GB,29,9,20,1,1v1 Random Map
2335213,guiguifal,30917,830,FR,16,6,10,1,1v1 Random Map
1145430,silverappples,30937,829,AU,142,66,76,0,1v1 Random Map
1012682,snaplockmerc,30938,829,NZ,11,3,8,1,1v1 Random Map
769395,remorabty,30942,829,DE,37,13,24,2,1v1 Random Map
2630501,Chalobeats✪,30953,829,CL,10,3,7,0,1v1 Random Map
1619492,rhajah,30980,829,US,34,16,18,1,1v1 Random Map
2599141,dub,31002,828,AR,13,4,9,2,1v1 Random Map
2199012,VictorHonorato,31013,828,BR,18,6,12,1,1v1 Random Map
1977420,TheCobra,31020,828,CL,42,16,26,3,1v1 Random Map
452004,Ozymandias,31040,827,AR,15,6,9,0,1v1 Random Map
2642409,saul.jam,31042,827,ES,18,7,11,0,1v1 Random Map
1949400,Jaimico,31063,827,AR,62,27,35,1,1v1 Random Map
1796134,freeth84,31067,827,AU,39,17,22,2,1v1 Random Map
1690855,punkpommes1,31068,827,DE,26,12,14,1,1v1 Random Map
1511649,CTHATSIT,31073,827,NA,41,17,24,0,1v1 Random Map
2516125,lucasrmusic,31097,826,NA,22,8,14,0,1v1 Random Map
2202853,martindq,31108,826,BE,112,54,58,1,1v1 Random Map
2129622,lucascornejolc3,31110,826,AR,14,5,9,1,1v1 Random Map
1865650,CatchingWalleye,31120,826,NA,18,6,12,1,1v1 Random Map
1093078,colaboks11,31137,825,NO,91,43,48,0,1v1 Random Map
2535559,shigeru1853,31154,825,NA,21,11,10,0,1v1 Random Map
2231185,sauBär >))))°>,31165,825,DE,25,9,16,0,1v1 Random Map
1090772,z(҂`_´)1,31192,824,DE,123,59,64,1,1v1 Random Map
694556,Zagor Magnus,31199,824,IT,18,7,11,0,1v1 Random Map
2252152,Kuip,31209,824,NL,33,13,20,1,1v1 Random Map
1931798,Mr_Yao,31215,824,ES,64,31,33,0,1v1 Random Map
1808855,sagaz0022,31219,824,BR,84,42,42,0,1v1 Random Map
898275,CodrinM345,31226,823,NA,201,85,116,6,1v1 Random Map
876556,Quesada,31227,823,BE,24,9,15,1,1v1 Random Map
2561152,g00sling,31246,823,US,141,70,71,0,1v1 Random Map
1521185,Gonza IV,31273,823,NA,20,8,12,2,1v1 Random Map
1475045,Danerpsy,31274,823,NA,279,132,147,17,1v1 Random Map
2323368,BigBoiSam,31300,822,GB,20,9,11,0,1v1 Random Map
2284788,j0930585129,31303,822,TW,67,31,36,5,1v1 Random Map
2171383,AT-AK,31305,822,DE,13,1,12,0,1v1 Random Map
1693974,Pablo Escobar,31326,822,SI,52,23,29,0,1v1 Random Map
2531664,010santigomez,31353,821,AR,70,33,37,5,1v1 Random Map
366271,Sickbambam,31365,821,AR,26,9,17,0,1v1 Random Map
2462038,Malkoçoğlu_!!!,31409,820,TR,20,10,10,1,1v1 Random Map
1806937,biohemp,31427,820,CZ,73,34,39,0,1v1 Random Map
1667378,디에고는 당신을 거시기,31432,820,AR,12,4,8,0,1v1 Random Map
1343776,mystic.life,31438,820,US,243,118,125,2,1v1 Random Map
2627362,Trachoxx,31451,819,CO,79,38,41,1,1v1 Random Map
283116,shuvro.ibaju,31484,818,IN,21,8,13,1,1v1 Random Map
1226863,rwilliamson001,31520,818,GB,38,14,24,3,1v1 Random Map
1007376,Contract,31521,817,US,31,13,18,6,1v1 Random Map
1969803,dadou679,31543,817,NA,15,5,10,0,1v1 Random Map
345564,sunny_32156,31546,817,CN,108,52,56,24,1v1 Random Map
1410602,Gartan,31556,817,FR,51,21,30,0,1v1 Random Map
1406290,HousedHun,31557,817,US,193,93,100,3,1v1 Random Map
1014752,Heretik Live,31564,816,NA,106,52,54,3,1v1 Random Map
2542508,omempo,31574,816,ID,25,10,15,0,1v1 Random Map
2361629,Batphan,31582,816,FR,178,87,91,11,1v1 Random Map
2108358,thomp951,31591,816,FR,12,4,8,0,1v1 Random Map
1948265,tomarabhishek326,31597,816,AU,136,67,69,5,1v1 Random Map
1692267,LordHenron99,31603,816,NA,17,6,11,0,1v1 Random Map
1082286,dejan,31610,815,SI,52,24,28,2,1v1 Random Map
2530208,][_____PAT_____][,31618,815,FR,22,8,14,0,1v1 Random Map
1850131,Dranzer13,31638,815,IN,14,5,9,0,1v1 Random Map
2289613,Llambitos Hope,31658,814,AR,19,7,12,0,1v1 Random Map
2273120,xalvaje,31661,814,CO,50,23,27,1,1v1 Random Map
1968898,Nomeh,31671,814,FR,20,8,12,1,1v1 Random Map
1966574,Binary Sunset,31672,814,GB,34,13,21,0,1v1 Random Map
774857,Sn0rxl,31693,813,DE,59,26,33,15,1v1 Random Map
2111504,cheese and whiskers,31714,813,CA,11,3,8,2,1v1 Random Map
1992953,Broz,31719,813,FR,10,2,8,0,1v1 Random Map
1949250,[Medula] moss07,31723,813,DE,13,4,9,0,1v1 Random Map
2450477,Skywalker OG,31743,812,TR,65,32,33,1,1v1 Random Map
1159965,southernrenegade916,31771,811,US,98,45,53,4,1v1 Random Map
2190330,AJGarcick,31796,811,CO,89,41,48,5,1v1 Random Map
1995149,josesanbol,31800,811,ES,20,7,13,0,1v1 Random Map
1801388,fortnitepro2007,31807,811,US,45,18,27,5,1v1 Random Map
299166,MasterMalicore,31814,811,US,232,112,120,1,1v1 Random Map
1932559,benconsci,31840,810,IT,110,52,58,6,1v1 Random Map
1778079,Wenchobaba,31848,810,IN,14,5,9,2,1v1 Random Map
254303,Marius,31896,808,NO,39,18,21,0,1v1 Random Map
476861,Dr4gonC0rn,31901,808,AU,197,94,103,4,1v1 Random Map
2318462,Harry dumblevord,31909,808,DK,25,9,16,0,1v1 Random Map
1840382,Blopapa7,31926,808,AR,27,10,17,5,1v1 Random Map
1270353,Choooc,31935,808,FR,19,8,11,0,1v1 Random Map
1918824,Gong,31966,807,FR,28,11,17,0,1v1 Random Map
219734,ridergr,31970,807,GR,85,39,46,3,1v1 Random Map
313351,PHOINIX,31972,807,AR,18,7,11,0,1v1 Random Map
2665182,Mati,31993,806,PL,13,4,9,0,1v1 Random Map
2392748,dominusz,32001,806,US,20,7,13,0,1v1 Random Map
2353947,UmustBeQuick,32002,806,CA,74,35,39,2,1v1 Random Map
1948237,HarleyQuinn,32013,806,LT,73,35,38,0,1v1 Random Map
1908493,akira519.dso,32016,806,ES,146,70,76,1,1v1 Random Map
1405887,griecojake,32022,806,US,16,5,11,0,1v1 Random Map
699203,a RTX 2070 Super,32030,805,DE,38,15,23,1,1v1 Random Map
365369,MarcusMaximus,32052,805,DE,207,101,106,10,1v1 Random Map
1579610,rvlander,32063,805,FR,25,10,15,0,1v1 Random Map
939873,Danielxu422,32079,804,JP,33,13,20,0,1v1 Random Map
674125,De.Wehrmacht,32082,804,DE,13,5,8,0,1v1 Random Map
240421,100Hz,32083,804,CH,16,5,11,0,1v1 Random Map
2232706,Pencho8940,32100,804,NA,41,18,23,0,1v1 Random Map
1765037,stonehands,32113,804,US,13,5,8,0,1v1 Random Map
2329647,nikhilsahu37,32140,803,IN,74,36,38,7,1v1 Random Map
2175934,Lord Sacramento,32143,803,GB,22,8,14,0,1v1 Random Map
1660968,SHuRiKeN,32156,803,ES,21,8,13,0,1v1 Random Map
210940,Redo,32168,802,DE,67,31,36,1,1v1 Random Map
2506576,Ultrasasa,32175,802,AU,18,6,12,0,1v1 Random Map
2470777,dj432,32177,802,GB,39,18,21,3,1v1 Random Map
2271183,oursblanc23,32185,802,FR,15,5,10,1,1v1 Random Map
1824893,maprettner,32196,802,AT,216,107,109,0,1v1 Random Map
1151605,gerniator,32202,801,AT,34,14,20,2,1v1 Random Map
898281,EIKX,32208,801,FR,17,5,12,0,1v1 Random Map
705256,killuminati01,32211,801,DE,18,6,12,0,1v1 Random Map
651518,StopSayingShubek,32213,801,AU,30,13,17,0,1v1 Random Map
442801,Ragnar,32214,801,SK,101,48,53,1,1v1 Random Map
2487275,Fitzy6221,32222,801,NA,22,10,12,0,1v1 Random Map
2390383,sjdlloyd,32230,801,NZ,38,16,22,1,1v1 Random Map
2625187,Mii,32263,800,ES,111,54,57,4,1v1 Random Map
2287584,TheZ,32272,800,TR,27,11,16,1,1v1 Random Map
1966081,MkCantona,32279,800,NA,30,11,19,0,1v1 Random Map
1745087,LukasVI6,32291,800,DE,10,2,8,0,1v1 Random Map
1275370,Aanomaly,32330,799,US,25,10,15,1,1v1 Random Map
2699718,AndreaKPiermart,32345,798,NA,24,8,16,0,1v1 Random Map
1563435,Novo88,32368,798,MX,23,7,16,0,1v1 Random Map
2701993,Femalethor,32416,796,US,14,5,9,0,1v1 Random Map
2471073,Zok0,32424,796,FR,24,9,15,0,1v1 Random Map
1957509,Joe Exotic,32438,796,DK,24,8,16,0,1v1 Random Map
1870323,Fluxxify,32441,796,US,36,14,22,2,1v1 Random Map
1868221,AlbertoMMC,32442,796,ES,77,37,40,1,1v1 Random Map
1223249,Kascher,32448,796,DE,70,31,39,0,1v1 Random Map
2709063,Benjaamon,32456,795,NA,22,7,15,0,1v1 Random Map
2596170,dunst,32459,795,DE,28,10,18,1,1v1 Random Map
1169447,Nomad5265,32484,794,NA,288,139,149,2,1v1 Random Map
188471,ShakierHail7395,32521,794,NA,17,5,12,1,1v1 Random Map
2661240,unsinnig,32536,793,DE,34,14,20,0,1v1 Random Map
245457,Pmadsboell,32578,792,DK,45,19,26,0,1v1 Random Map
2485033,antoinejammin,32584,792,FR,28,12,16,0,1v1 Random Map
2262371,benoo2,32586,792,NA,10,1,9,0,1v1 Random Map
1851060,danyisokay,32633,791,IN,10,2,8,0,1v1 Random Map
1238466,Tekno,32641,791,FI,48,25,23,0,1v1 Random Map
2073702,Darth Llahma,32735,788,US,106,49,57,0,1v1 Random Map
1703727,Rixnn,32744,788,FR,11,3,8,0,1v1 Random Map
1032056,boudiou76,32755,787,NA,50,21,29,0,1v1 Random Map
492064,Quetschkopf,32759,787,DE,20,7,13,0,1v1 Random Map
2316210,druidcipki,32772,787,PL,62,29,33,1,1v1 Random Map
2280404,Thorjim1958,32773,787,NA,246,122,124,5,1v1 Random Map
1906751,PoTeToesFriTe,32783,787,NA,65,21,44,3,1v1 Random Map
2582510,[COL] _manu,32795,786,CO,234,115,119,12,1v1 Random Map
1367483,JohnSun,32817,786,US,12,3,9,0,1v1 Random Map
984137,christoph.ollinger2003,32822,785,AT,183,91,92,2,1v1 Random Map
516556,hitman_fucsia,32826,785,PE,86,37,49,3,1v1 Random Map
2547812,Mongo,32830,785,GB,37,17,20,3,1v1 Random Map
2016495,MrManchini,32845,785,AR,71,32,39,1,1v1 Random Map
2453401,DARK BIRDY ( Panpantmort),32864,784,FR,11,3,8,0,1v1 Random Map
1953350,Hpello,32876,784,FR,51,24,27,0,1v1 Random Map
1129715,FaizMeister,32884,783,IN,14,4,10,0,1v1 Random Map
867045,Sopaipleto,32886,783,CL,30,9,21,0,1v1 Random Map
2299343,danielsarussi,32898,783,IL,10,3,7,0,1v1 Random Map
1356432,roguestar99,32917,783,GB,101,46,55,11,1v1 Random Map
1171690,Kickass,32919,782,FR,68,30,38,4,1v1 Random Map
963334,BIGBOSS,32922,782,IN,164,77,87,9,1v1 Random Map
2053293,lois.pavillet,32947,782,FR,83,38,45,1,1v1 Random Map
2615882,aicason,32972,781,ES,19,6,13,0,1v1 Random Map
1966835,fred,33021,780,US,12,3,9,0,1v1 Random Map
1436498,OeilEclairage8,33058,779,NA,22,10,12,0,1v1 Random Map
2326266,Disabled Potato,33075,778,US,199,95,104,0,1v1 Random Map
2122574,Matz,33082,778,CL,10,2,8,0,1v1 Random Map
2295642,iquinteroe23,33114,777,MX,22,6,16,0,1v1 Random Map
2416408,PuceJellyfish91,33141,776,NA,139,67,72,0,1v1 Random Map
2349207,Zabir377,33144,776,BD,45,18,27,0,1v1 Random Map
438459,RattigerRasierer13,33165,775,DE,66,30,36,5,1v1 Random Map
2178397,jasmine,33180,775,GB,16,5,11,0,1v1 Random Map
1966313,Kosack,33187,775,DE,23,7,16,0,1v1 Random Map
1250124,SpiDerWiRe29,33201,775,US,123,58,65,4,1v1 Random Map
1959832,White Noise Addict,33222,774,US,11,3,8,0,1v1 Random Map
1337413,snell590,33230,774,FR,17,7,10,0,1v1 Random Map
2051600,Fenix,33258,773,AR,29,11,18,0,1v1 Random Map
1040574,juanchito2866,33270,772,NL,13,4,9,0,1v1 Random Map
647100,ARaGon,33274,772,AR,305,149,156,7,1v1 Random Map
1915171,GoutteMetal5031,33293,772,FR,100,46,54,3,1v1 Random Map
2216204,Peter',33315,771,UY,12,3,9,0,1v1 Random Map
2171535,d-deutscher,33316,771,DE,85,40,45,5,1v1 Random Map
1686121,DerWicht,33346,770,CH,151,73,78,4,1v1 Random Map
739293,guirosario,33352,769,BR,19,5,14,0,1v1 Random Map
2114193,ChusElSanto,33369,769,NA,47,21,26,0,1v1 Random Map
1942728,Darkeside44,33374,769,NL,18,6,12,0,1v1 Random Map
2181126,billups9690,33414,768,NA,71,31,40,1,1v1 Random Map
2561750,Nuunno,33435,767,BR,11,3,8,0,1v1 Random Map
2517383,SpartanLord375,33455,766,AE,51,23,28,0,1v1 Random Map
1808667,daviddosch,33473,766,US,14,4,10,0,1v1 Random Map
1445594,antoinedeutsch,33475,766,FR,31,11,20,0,1v1 Random Map
1977824,69 Love,33491,765,BR,23,8,15,0,1v1 Random Map
248763,-$LordNugget$-,33505,764,DE,76,34,42,1,1v1 Random Map
2068369,Flocelot,33518,764,NA,24,9,15,1,1v1 Random Map
2019011,Balogna_Police,33520,764,US,15,5,10,0,1v1 Random Map
1390472,thomas,33526,764,AT,12,3,9,0,1v1 Random Map
2095871,ProPosition Joe,33546,763,GE,37,14,23,1,1v1 Random Map
1812547,Ravana,33548,763,CA,174,84,90,1,1v1 Random Map
1566296,Andy Ritter,33550,763,DE,44,20,24,1,1v1 Random Map
2623834,Vardenz,33561,762,MY,23,7,16,0,1v1 Random Map
1510230,heduh5,33588,762,CH,12,3,9,0,1v1 Random Map
2635694,joselillo969,33600,761,ES,85,40,45,1,1v1 Random Map
2575067,Momolucky21,33602,761,NA,34,16,18,0,1v1 Random Map
2108504,No Drama Lama,33609,761,DE,12,3,9,0,1v1 Random Map
1866116,PitoHNKoAaN2,33616,761,NA,21,9,12,0,1v1 Random Map
1481040,PHA,33621,761,CH,20,7,13,0,1v1 Random Map
2417237,DeKo,33634,760,DE,22,8,14,0,1v1 Random Map
533452,alexis.dasilva,33649,759,FR,10,2,8,1,1v1 Random Map
2494291,FerNaND,33653,759,MX,27,12,15,0,1v1 Random Map
2309690,Martok,33657,759,FR,19,6,13,0,1v1 Random Map
1121217,JustOutOfRange,33665,758,US,33,12,21,1,1v1 Random Map
2433470,Rowschank,33678,758,DE,17,6,11,0,1v1 Random Map
1910322,joris_aerden,33723,757,BE,14,3,11,0,1v1 Random Map
2305828,gamdan89,33764,755,NL,13,3,10,0,1v1 Random Map
2250082,Maribona1994,33765,755,ES,12,3,9,0,1v1 Random Map
826956,Bobhenry,33829,752,US,67,29,38,2,1v1 Random Map
419403,Ashy,33833,752,AU,24,9,15,0,1v1 Random Map
2401141,eskitepeli,33837,752,TR,23,9,14,3,1v1 Random Map
2035048,berend604,33842,752,NA,19,7,12,1,1v1 Random Map
760173,sunshine,33857,751,US,125,60,65,15,1v1 Random Map
1101488,TheMyth,33882,750,ZA,45,19,26,1,1v1 Random Map
2315224,AlmightySleet29,33892,750,NA,27,9,18,1,1v1 Random Map
2295964,MambO-.,33893,750,AR,27,11,16,4,1v1 Random Map
2222297,Red-One,33898,750,BE,54,24,30,2,1v1 Random Map
2051910,Geronimo,33900,750,CH,50,21,29,3,1v1 Random Map
218936,hoop,33926,749,SE,84,38,46,1,1v1 Random Map
2306099,kellandlhead,33940,748,US,19,4,15,0,1v1 Random Map
1559866,suansita,33977,747,AU,26,7,19,2,1v1 Random Map
2480410,Lore_15,33985,746,CO,16,4,12,0,1v1 Random Map
1923529,celerytree,34036,744,NA,16,4,12,0,1v1 Random Map
2433373,MacronLePrésident,34050,743,FR,111,51,60,4,1v1 Random Map
2413042,BOT Oliver,34051,743,DE,16,4,12,0,1v1 Random Map
2567185,SérdnaVirgós,34070,742,ES,30,10,20,0,1v1 Random Map
1390405,xeixax,34082,742,NA,298,140,158,3,1v1 Random Map
1493143,空白,34107,741,US,59,26,33,0,1v1 Random Map
2230578,Boris,34125,740,SV,73,33,40,2,1v1 Random Map
2087581,cenkaydin61,34127,740,TR,16,4,12,0,1v1 Random Map
1425102,Mimolette,34134,740,FR,16,4,12,0,1v1 Random Map
1065845,deyie angle,34136,739,CN,83,36,47,0,1v1 Random Map
2360816,Dodu,34145,739,FR,31,12,19,1,1v1 Random Map
2519558,OG | shreyash,34190,737,IN,18,5,13,0,1v1 Random Map
2041689,Natsukf,34204,737,BR,13,3,10,10,1v1 Random Map
1948264,Chico,34205,737,FR,23,8,15,0,1v1 Random Map
1933740,giuligenti,34206,737,AR,84,38,46,2,1v1 Random Map
2342356,ZatakSucks,34222,736,US,16,6,10,3,1v1 Random Map
2213923,svalles,34226,736,AR,13,3,10,1,1v1 Random Map
1293092,Ana-logKid,34235,736,US,10,2,8,1,1v1 Random Map
2035566,tanja_maracuja,34253,735,CH,38,16,22,0,1v1 Random Map
945456,Tschanni,34263,734,DE,55,24,31,0,1v1 Random Map
437318,Robbyn Arzuhl,34267,734,NA,50,20,30,2,1v1 Random Map
730267,hisensse,34289,733,AR,54,24,30,4,1v1 Random Map
2388524,jbman35,34321,732,FR,14,3,11,0,1v1 Random Map
1977980,Fausty92,34330,732,FR,214,104,110,2,1v1 Random Map
1426994,MoreTock,34335,732,FR,20,6,14,0,1v1 Random Map
892565,GrapeNuttSoup,34360,730,US,58,26,32,1,1v1 Random Map
2464261,Necrosdarkborn,34364,730,US,10,2,8,0,1v1 Random Map
2069797,beargorilla,34368,730,US,36,13,23,0,1v1 Random Map
1885074,polixe12,34370,730,DK,191,94,97,4,1v1 Random Map
462495,Hayvanmonky,34377,729,DE,115,52,63,3,1v1 Random Map
1469974,DumDum,34395,729,BE,27,8,19,0,1v1 Random Map
2454843,Tallaksen,34404,728,NO,72,31,41,3,1v1 Random Map
1946290,adamc921,34417,728,US,22,7,15,0,1v1 Random Map
2362786,SchoolAunt4187,34454,726,NA,92,42,50,6,1v1 Random Map
2341455,WinterMint12155,34471,725,NA,23,6,17,0,1v1 Random Map
2279192,jmcurci,34472,725,AR,24,10,14,0,1v1 Random Map
2587954,Vasilex,34484,724,ES,59,25,34,2,1v1 Random Map
2113856,djo.lancaster,34506,723,GB,17,4,13,0,1v1 Random Map
1852553,Pagano1990,34512,723,AR,99,44,55,0,1v1 Random Map
1065855,DimitriosGreat,34519,722,GR,31,10,21,0,1v1 Random Map
1921911,thesheriff8605,34534,722,NA,15,3,12,1,1v1 Random Map
471575,2873414537,34543,721,CN,37,16,21,4,1v1 Random Map
2468465,Nicolllolll,34565,720,NA,33,13,20,0,1v1 Random Map
2148302,SamHouston89,34571,720,NA,127,59,68,1,1v1 Random Map
1435779,jeriendenblanken,34596,719,NL,50,19,31,1,1v1 Random Map
2393456,Druss_Goax,34622,717,FR,67,31,36,8,1v1 Random Map
2152243,bluecloud,34629,717,BE,29,8,21,2,1v1 Random Map
575538,Verdusco,34642,716,PE,100,47,53,2,1v1 Random Map
2019439,Facu,34652,716,AR,14,3,11,0,1v1 Random Map
2413964,steveberger90,34676,714,CH,20,6,14,1,1v1 Random Map
135426,PITONCITO,34689,713,NA,70,22,48,1,1v1 Random Map
474041,naps,34690,713,CL,43,16,27,0,1v1 Random Map
2475864,One Love Nadine,34693,713,FR,44,19,25,0,1v1 Random Map
2291550,ederps24,34710,712,NA,47,18,29,5,1v1 Random Map
1925516,paXyyy,34734,711,TR,21,6,15,0,1v1 Random Map
2415927,Ex Milkman,34745,710,NA,51,20,31,0,1v1 Random Map
916283,Quetzalcoatl,34765,708,NL,14,2,12,0,1v1 Random Map
2119393,Ruz,34775,708,FR,21,6,15,0,1v1 Random Map
2154068,[LFE] M.Heisenberg,34804,706,FR,28,10,18,0,1v1 Random Map
2133330,A muscular hobo,34822,705,NA,11,2,9,1,1v1 Random Map
1408458,MGKelvin,34828,705,NL,19,5,14,1,1v1 Random Map
2346991,SugaryHades3195,34862,702,NA,13,4,9,0,1v1 Random Map
1888599,minmb82,34869,702,IL,21,7,14,4,1v1 Random Map
2321686,tnxnaz,34875,701,GB,11,2,9,1,1v1 Random Map
346285,rivfader,34882,701,AT,224,105,119,3,1v1 Random Map
2409280,julipro7207,34903,699,NA,20,6,14,2,1v1 Random Map
724221,kevin_the_menance,34919,698,US,360,172,188,9,1v1 Random Map
1999454,nicopizzini92,34934,697,AR,25,10,15,0,1v1 Random Map
1779819,JaHnu-,34935,697,FR,10,1,9,0,1v1 Random Map
1356104,Chryasor,34937,697,SE,38,14,24,1,1v1 Random Map
2286060,ACE SAFT,34944,696,DE,132,62,70,7,1v1 Random Map
602678,jlrs7,34957,694,NA,45,14,31,0,1v1 Random Map
429240,[Alpha] Traslanovic,34959,694,DE,25,9,16,2,1v1 Random Map
2050161,GengisKhan1006,34966,694,NA,110,32,78,13,1v1 Random Map
2039266,FedeLv,34967,694,AR,40,17,23,21,1v1 Random Map
2020448,Forgoto Get-Loom,34969,694,NZ,31,10,21,0,1v1 Random Map
1925397,Karmo,34971,694,FR,59,26,33,0,1v1 Random Map
1714303,djcorynorie,34972,694,AU,14,3,11,0,1v1 Random Map
1865642,pupurangame,34987,693,JP,34,10,24,2,1v1 Random Map
2303338,RELIF89,35010,691,NA,36,13,23,0,1v1 Random Map
299571,[DoD]ForestSpirit,35017,691,AU,101,44,57,10,1v1 Random Map
1090912,Bushman,35018,690,CA,20,5,15,1,1v1 Random Map
2749663,gabriel.aviles,35019,690,CL,14,2,12,0,1v1 Random Map
2382607,parruski,35092,685,US,34,12,22,1,1v1 Random Map
2474071,TwoBeers,35116,683,DE,21,5,16,2,1v1 Random Map
1611977,teotabd,35120,683,FR,23,8,15,1,1v1 Random Map
2410719,Chicken Bo,35125,682,US,37,11,26,0,1v1 Random Map
1869297,sevi85,35138,681,ES,138,67,71,1,1v1 Random Map
487429,Chuck_Norris,35143,680,GB,24,7,17,0,1v1 Random Map
1085609,Va.China,35194,676,AT,186,87,99,1,1v1 Random Map
2557877,Dixon Ormous,35196,676,CA,30,12,18,0,1v1 Random Map
560893,avatarfanx2,35249,671,US,15,3,12,1,1v1 Random Map
2346155,izaro.iruj,35262,670,IT,60,25,35,4,1v1 Random Map
2125968,janamen,35272,669,NA,38,17,21,0,1v1 Random Map
2527103,Cricru,35295,666,FR,29,7,22,0,1v1 Random Map
1689106,Koltira,35298,666,CZ,136,58,78,7,1v1 Random Map
763830,jami0208,35320,663,DE,16,2,14,0,1v1 Random Map
639361,DeejayM1CH4,35322,663,NA,15,3,12,0,1v1 Random Map
2585393,大騙子諾蘭德,35330,662,TW,15,3,12,1,1v1 Random Map
2388467,Schnevullock,35332,662,NA,20,6,14,0,1v1 Random Map
2648236,Rimmer,35354,659,GB,12,2,10,0,1v1 Random Map
1371177,jmpalvarez,35361,659,ES,40,14,26,0,1v1 Random Map
849464,brucekilla,35362,658,US,130,58,72,4,1v1 Random Map
2531129,RavenMcNeven,35383,656,NA,17,4,13,0,1v1 Random Map
1875322,ssbm_schlimmshady,35419,652,DE,56,23,33,0,1v1 Random Map
260937,TMountana,35444,648,NA,121,53,68,1,1v1 Random Map
2632268,!BİGG_SMOKE,35448,648,TR,26,7,19,5,1v1 Random Map
2395392,juancamiloparra,35449,648,NA,141,66,75,14,1v1 Random Map
2171965,rezwone,35468,646,US,32,10,22,0,1v1 Random Map
276451,il-Qanfud,35486,643,CO,79,33,46,1,1v1 Random Map
2480413,Terry Mabel,35490,643,US,25,7,18,0,1v1 Random Map
2326373,LavenderOwl4980,35491,643,NA,27,9,18,1,1v1 Random Map
200845,MrMeseeks,35495,642,US,27,10,17,1,1v1 Random Map
622198,paetz26,35498,641,DE,27,8,19,0,1v1 Random Map
621035,Manu45657,35499,641,NA,25,7,18,0,1v1 Random Map
862151,Flexo,35511,639,DE,10,1,9,0,1v1 Random Map
2573299,Mazak_Kazam,35520,638,PL,33,12,21,1,1v1 Random Map
2628049,barra12,35531,637,ES,15,4,11,0,1v1 Random Map
2290428,FiwiPITO,35534,637,NA,100,43,57,4,1v1 Random Map
1148870,chauch,35540,636,CA,124,56,68,4,1v1 Random Map
1924138,Kachowrc235,35550,635,NA,20,5,15,0,1v1 Random Map
2029106,On error resume next,35564,633,TR,49,20,29,10,1v1 Random Map
2205816,298382,35616,624,RU,32,11,21,1,1v1 Random Map
598151,nosil-49,35640,621,FR,46,17,29,3,1v1 Random Map
1509517,dasandwich69,35659,620,AU,30,9,21,1,1v1 Random Map
2740854,adamphillipsinbox,35661,619,AU,35,12,23,0,1v1 Random Map
2626950,Lluismergo,35681,615,ES,13,1,12,0,1v1 Random Map
2650000,matias_valenzuela,35690,613,CL,62,21,41,0,1v1 Random Map
2667977,CHRISTO LE ROI8,35706,610,NA,98,43,55,0,1v1 Random Map
2427327,jgvido,35707,610,NA,19,5,14,0,1v1 Random Map
2549008,FloDut4214,35743,602,NA,17,3,14,0,1v1 Random Map
2586455,Yanikurasu,35770,598,DE,10,0,10,0,1v1 Random Map
2487336,---,35809,590,US,11,0,11,0,1v1 Random Map
2237898,stevenjfink,35812,589,NA,257,123,134,2,1v1 Random Map
622943,Mahoni2017,35845,581,NA,205,90,115,20,1v1 Random Map
116978,alexdean91,35864,577,GB,82,30,52,2,1v1 Random Map
2093682,Frédéric,35877,574,CH,91,40,51,5,1v1 Random Map
2485066,lamalitos,35887,571,RU,12,0,12,0,1v1 Random Map
2295913,Žø®ßᾇ™,35890,571,BR,22,4,18,0,1v1 Random Map
2048752,Poojan,35892,570,IN,16,5,11,0,1v1 Random Map
583001,Amyas777,35895,569,NA,30,8,22,2,1v1 Random Map
1772007,Kingofdwarfs,35911,565,FR,112,46,66,23,1v1 Random Map
1675475,ekurtyukov,35956,549,RU,58,23,35,5,1v1 Random Map
2497169,like29zombies,35961,546,US,17,2,15,1,1v1 Random Map
2107437,WichoChuletas,35972,543,MX,88,31,57,3,1v1 Random Map
2751422,Fat_Tom_Cat,35975,542,SK,19,3,16,0,1v1 Random Map
2234637,MontyTheGoth,36012,522,DE,67,26,41,30,1v1 Random Map
2360884,noninonal,36019,516,FR,15,1,14,1,1v1 Random Map
2055238,SirPresident765,36020,515,NA,202,88,114,8,1v1 Random Map
2052707,Mikail,36024,513,TR,53,18,35,1,1v1 Random Map
1803881,VDO Corneiillus,36025,513,NA,45,11,34,4,1v1 Random Map
2052022,Maratone,36028,511,DK,13,1,12,1,1v1 Random Map
2151268,ElioJamesDio89,36046,499,NA,38,11,27,7,1v1 Random Map
1940772,SurgicalSoap776,36066,487,NA,36,3,33,3,1v1 Random Map
2319916,GloatingBird270,36076,480,NA,34,8,26,3,1v1 Random Map
1643539,IRISHfireman20,36107,451,NA,12,0,12,2,1v1 Random Map
2285969,enesgurkan,36126,445,NA,88,32,56,8,1v1 Random Map
1731046,ibi.zayed,36150,405,DE,29,4,25,1,1v1 Random Map
1753189,Custom Action,36175,315,DE,36,0,36,0,1v1 Random Map
1195260,Kellar,8,2728,NO,364,319,45,2,Team Random Map
312774,Sun | Keno_,9,2725,MX,300,238,62,4,Team Random Map
560474,Sunzets,10,2721,MX,253,191,62,4,Team Random Map
199419,gkt_cloud,49,2618,TW,749,536,213,8,Team Random Map
332603,teutonic_tanks,54,2616,AT,280,237,43,9,Team Random Map
1892228,KaN,57,2614,AR,211,153,58,2,Team Random Map
101103,TheVuki,83,2581,DE,620,379,241,5,Team Random Map
316555,neromelnick,84,2580,CL,170,118,52,0,Team Random Map
2413974,Roggy,96,2566,TR,195,138,57,5,Team Random Map
1097738,PuMpKiN,100,2561,GB,190,123,67,3,Team Random Map
2063382,Bobdedestructor,104,2555,DK,256,179,77,13,Team Random Map
230432,steakmaster,106,2553,GB,590,392,198,7,Team Random Map
222102,Annotoph,109,2549,DE,561,407,154,5,Team Random Map
199170,dogao,110,2548,BR,267,230,37,8,Team Random Map
225365,Obadiah,118,2544,CA,332,253,79,4,Team Random Map
1189246,SC_Acti0n,128,2540,BR,330,218,112,5,Team Random Map
235623,Twitch.tv | SpringTV,149,2524,US,603,426,177,6,Team Random Map
2382926,VN_MiLLeNcOlin,158,2520,MX,74,49,25,0,Team Random Map
216073,MaxiArg,175,2510,AR,237,197,40,5,Team Random Map
254567,bav_tarantula,186,2505,DE,400,282,118,22,Team Random Map
355871,Grinder,188,2505,RU,91,71,20,0,Team Random Map
942980,Sir_Tableflipper,195,2501,RO,127,88,39,0,Team Random Map
2534796,NMNKING,197,2500,RU,168,103,65,5,Team Random Map
259265,chiefChing,205,2497,GB,546,345,201,11,Team Random Map
1868958,tr3VS_,212,2494,BR,312,212,100,8,Team Random Map
2691747,Kram,223,2492,FI,104,86,18,0,Team Random Map
268565,RoR | Luca8761,234,2487,CA,349,297,52,5,Team Random Map
216736,JaySquared,240,2485,DE,333,279,54,1,Team Random Map
498973,GoodMan,251,2479,GB,169,108,61,1,Team Random Map
269023,Pichaku,271,2470,BR,710,457,253,6,Team Random Map
261045,BlackCoffee,272,2470,US,913,506,407,13,Team Random Map
2373778,ZZZ,286,2461,CN,169,112,57,8,Team Random Map
249430,Av3stan,297,2456,PT,405,263,142,6,Team Random Map
348134,Erge_____,329,2448,CN,112,89,23,4,Team Random Map
196005,Dufon,331,2447,PT,254,146,108,4,Team Random Map
1514640,ShadowWalker,334,2445,PL,251,154,97,8,Team Random Map
401359,Twitch.com/Lord_Envidiates,354,2438,MX,777,434,343,36,Team Random Map
219493,TheSniper_AOE,399,2428,FR,460,329,131,4,Team Random Map
1829213,Falcao,410,2425,BR,330,203,127,17,Team Random Map
547152,Bella_Ciao,415,2423,TR,188,147,41,4,Team Random Map
779225,kgbrenan,425,2420,BR,473,311,162,7,Team Random Map
229230,Calalpaco,446,2416,IT,332,217,115,10,Team Random Map
17166,Lay'sCola,461,2414,CN,259,184,75,11,Team Random Map
258972,DriNkY_T,470,2412,DE,167,112,55,4,Team Random Map
1347107,Baafmeister,474,2412,NL,157,104,53,2,Team Random Map
2160699,Gamewall.io,493,2408,GR,90,62,28,1,Team Random Map
1444347,StrikingFan,496,2408,DE,711,400,311,47,Team Random Map
216107,[bK] guizica,500,2407,BR,252,166,86,9,Team Random Map
2564117,il 🚽,505,2406,GB,88,66,22,0,Team Random Map
545512,你是很大ON9JAI,533,2400,NO,177,122,55,2,Team Random Map
910232,小四,546,2395,TW,429,265,164,10,Team Random Map
2386022,HACHIGERI,555,2391,JP,150,95,55,0,Team Random Map
209966,徐仙,557,2390,CN,257,163,94,13,Team Random Map
208757,HeavenlyChorus,560,2388,CN,251,199,52,6,Team Random Map
226861,_Mich_,577,2382,IT,155,105,50,4,Team Random Map
233707,Brentajacied,588,2378,NL,318,201,117,4,Team Random Map
336785,Kamitsure,601,2374,CN,482,283,199,26,Team Random Map
573336,太史慈,605,2370,TW,175,94,81,4,Team Random Map
1073722,Looki,613,2368,FR,374,227,147,5,Team Random Map
243287,Mustard Pudding,637,2363,CN,242,188,54,11,Team Random Map
212921,Albert_Stone,650,2360,MX,235,169,66,8,Team Random Map
209204,Killer_Storm_,663,2358,IT,688,353,335,8,Team Random Map
120105,hchxie,669,2357,CN,374,248,126,17,Team Random Map
2521572,Mahya_  I  Twitch.tv,673,2357,MA,104,64,40,21,Team Random Map
351793,Moonfaller,674,2357,NL,419,254,165,12,Team Random Map
301422,Dacc,675,2357,CN,139,96,43,7,Team Random Map
339170,Kuo,687,2354,TW,160,104,56,4,Team Random Map
316084,OMurchu,696,2353,DE,211,133,78,5,Team Random Map
312938,BacT,697,2353,VN,165,136,29,4,Team Random Map
1821855,tanglang,716,2348,CN,272,180,92,2,Team Random Map
741271,_Ats,719,2347,BR,44,31,13,0,Team Random Map
196240,TheViper,723,2347,DE,104,86,18,8,Team Random Map
241275,Silver,741,2342,GB,438,260,178,18,Team Random Map
219663,Bujakabla,744,2342,DE,756,424,332,33,Team Random Map
1788064,我在时间尽头等你,761,2337,CN,56,36,20,3,Team Random Map
631646,[mPzzA] rainManzD,777,2333,US,686,330,356,21,Team Random Map
2419773,Pickle Rick,778,2333,DE,110,81,29,0,Team Random Map
1074476,PurePudding,782,2332,TW,256,154,102,4,Team Random Map
62374,折磨王,807,2329,CN,149,107,42,4,Team Random Map
2262981,Anette,841,2322,DE,262,134,128,3,Team Random Map
2302354,Richard,858,2318,GB,194,108,86,5,Team Random Map
330443,Chives,859,2318,US,194,108,86,1,Team Random Map
2680420,Tuti,885,2313,FR,37,26,11,0,Team Random Map
214558,Fox,894,2311,US,447,257,190,11,Team Random Map
297683,fcasalen,901,2311,BR,393,226,167,17,Team Random Map
1520958,dreibasti,909,2309,DE,216,142,74,8,Team Random Map
307076,bushi27,910,2309,GR,632,430,202,14,Team Random Map
216056,boomer,911,2309,US,592,417,175,17,Team Random Map
778725,Skrillll,913,2308,MA,425,252,173,20,Team Random Map
593703,lsa,918,2306,CN,712,350,362,45,Team Random Map
233587,Barkovian,945,2303,FI,394,228,166,42,Team Random Map
208701,[mPzzA] K1,947,2303,IR,413,224,189,33,Team Random Map
543093,Ann0r,957,2302,DE,252,200,52,5,Team Random Map
21044,The_Barto,963,2302,CO,201,117,84,9,Team Random Map
730394,SNWY4,991,2295,GB,375,182,193,8,Team Random Map
494384,raremome,1000,2294,JP,150,110,40,0,Team Random Map
238458,Barba_Amarillo.,1002,2293,MX,79,67,12,1,Team Random Map
1857655,ReadyFreddy,1015,2291,DE,126,74,52,0,Team Random Map
242134,Kieronortti,1017,2290,FI,314,189,125,22,Team Random Map
2345306,hangemhigh,1019,2290,TR,66,52,14,0,Team Random Map
898389,?,1020,2289,CL,618,329,289,49,Team Random Map
453821,Macluffy,1022,2289,BE,68,55,13,0,Team Random Map
213427,Subzer0,1033,2287,US,143,92,51,2,Team Random Map
2686343,NakedNipples,1036,2287,US,22,17,5,0,Team Random Map
594823,Kiskae,1044,2286,NO,558,324,234,11,Team Random Map
574945,TheMole - 67,1057,2284,FR,152,100,52,2,Team Random Map
336400,Atlas,1059,2284,GB,175,104,71,3,Team Random Map
491197,Hansando,1096,2277,KR,1252,777,475,54,Team Random Map
382055,Poolparty,1097,2277,AR,274,164,110,12,Team Random Map
1495037,Elroundyy,1106,2276,DE,301,161,140,5,Team Random Map
262307,AncientMr.Lu$t,1125,2272,DE,442,244,198,9,Team Random Map
355537,_sala,1131,2271,HK,674,405,269,9,Team Random Map
325696,Killer,1134,2271,US,536,364,172,7,Team Random Map
221824,LEON,1145,2270,FR,1670,967,703,76,Team Random Map
1117520,Rafellipe_rlZ,1205,2259,CA,348,190,158,6,Team Random Map
280827,Villiams!,1218,2257,US,121,75,46,1,Team Random Map
1295253,Zuo,1241,2252,GB,280,160,120,1,Team Random Map
931567,Wish,1247,2250,SE,407,222,185,4,Team Random Map
1206772,Zasa,1252,2250,TR,194,117,77,4,Team Random Map
2116604,squeaker,1274,2246,GB,164,80,84,3,Team Random Map
1336377,vasco_77,1287,2244,AR,306,144,162,4,Team Random Map
867046,Nuno,1294,2242,BR,123,85,38,3,Team Random Map
1312692,Radman,1311,2239,GB,227,145,82,4,Team Random Map
2462063,Ciclar Memb,1315,2238,IT,40,32,8,1,Team Random Map
364336,Nemo,1317,2238,IT,141,86,55,4,Team Random Map
1867537,galigeigei44,1318,2238,CN,159,101,58,4,Team Random Map
1465263,biliblil丶枭,1333,2235,CN,222,123,99,8,Team Random Map
87617,tomorrowcomestoday,1336,2234,AR,264,174,90,13,Team Random Map
2237145,cz.jarosa,1345,2233,CZ,54,43,11,1,Team Random Map
293417,Wildey,1350,2232,GB,453,253,200,35,Team Random Map
201179,MazZ,1352,2232,AR,105,60,45,1,Team Random Map
422452,IvaS,1379,2226,ES,423,243,180,3,Team Random Map
1326038,RESİDENT TÜRBANLI : BOMBA,1395,2225,TR,441,234,207,12,Team Random Map
1047969,Elvemage,1402,2223,PT,207,117,90,2,Team Random Map
398379,RealDostoyevski,1412,2221,TR,194,99,95,17,Team Random Map
932993,G00Dfellaz-GyN,1416,2220,AR,420,232,188,6,Team Random Map
2431066,dodge all abnormal maps,1429,2219,NL,103,52,51,0,Team Random Map
1826067,Fly like Django,1436,2218,DE,184,106,78,2,Team Random Map
2337179,PamelAnderson,1449,2216,BR,28,20,8,0,Team Random Map
2152667,NickCutterFan,1469,2213,DE,265,134,131,5,Team Random Map
1968372,Rompe_CU,1494,2209,AR,271,154,117,3,Team Random Map
232707,Citifiedjungle,1497,2208,NO,506,248,258,46,Team Random Map
261535,Faranight,1503,2207,ES,125,80,45,2,Team Random Map
247690,Leppard,1521,2204,GB,268,160,108,3,Team Random Map
1421273,RoZZoR,1526,2204,DE,94,66,28,2,Team Random Map
445587,htolS,1535,2202,US,194,131,63,4,Team Random Map
280459,AoL_RecoN,1582,2194,GB,75,63,12,1,Team Random Map
2044492,Soldadito de Plomo,1586,2194,MX,277,149,128,10,Team Random Map
669217,MrNiceGuy,1601,2192,DE,541,292,249,12,Team Random Map
1184825,Edkal,1617,2191,FR,73,53,20,0,Team Random Map
251775,_MidGard_,1630,2189,IT,280,147,133,6,Team Random Map
336983,Thomasbeer,1635,2189,NL,227,150,77,15,Team Random Map
2432919,Returned_Legend,1642,2188,US,253,115,138,11,Team Random Map
1247388,w(oO)t,1655,2186,NZ,264,154,110,2,Team Random Map
973305,Cryster,1663,2184,CH,266,160,106,15,Team Random Map
255199,WizardHsc,1664,2184,BR,240,134,106,6,Team Random Map
220792,Don_Pablo,1691,2181,DE,114,76,38,1,Team Random Map
249344,StrikeOut[MD],1711,2178,DE,930,498,432,16,Team Random Map
506834,_CAXCAN_,1741,2174,MX,546,322,224,9,Team Random Map
496227,Mr_T0,1742,2174,DE,234,135,99,3,Team Random Map
289624,_guga,1749,2174,BR,344,207,137,10,Team Random Map
280436,Abdel,1750,2173,MX,128,79,49,3,Team Random Map
226140,PhantasticPhil,1760,2172,AT,459,266,193,18,Team Random Map
294276,Belial-,1778,2170,NZ,401,227,174,11,Team Random Map
1091018,MNP,1789,2168,TR,235,138,97,2,Team Random Map
888511,ExtRaDaRk_,1790,2168,TR,88,65,23,2,Team Random Map
1150604,Fatihaydemir38,1807,2166,NL,169,95,74,13,Team Random Map
1742969,SS_Tiranus,1824,2165,BR,376,179,197,6,Team Random Map
981941,Nizzdramati,1830,2164,CZ,176,108,68,5,Team Random Map
250307,Elabayalde,1851,2162,PE,666,396,270,29,Team Random Map
210888,SilentTV,1853,2162,AR,209,128,81,1,Team Random Map
222418,Nightmare,1856,2162,NL,119,96,23,1,Team Random Map
1752510,TheJokeer,1857,2162,DE,290,187,103,9,Team Random Map
2394084,Pikeman,1892,2158,AR,106,72,34,6,Team Random Map
223826,Gurkerllift,1894,2158,AT,362,211,151,2,Team Random Map
605547,Kwai,1902,2157,CA,249,135,114,5,Team Random Map
306756,TheCapeMan,1928,2155,CA,167,119,48,5,Team Random Map
918734,andychen662000,1945,2153,TW,262,146,116,7,Team Random Map
404048,TheChemist,1952,2152,US,178,118,60,8,Team Random Map
12466,Panbauletto,1958,2151,IT,175,106,69,7,Team Random Map
1914868,Goss,1967,2151,FR,307,147,160,23,Team Random Map
286096,Mario,2031,2143,DE,440,240,200,6,Team Random Map
265163,I_AM_CHRIS,2033,2143,CO,169,117,52,5,Team Random Map
268639,Facho.Pobre,2038,2142,AR,284,182,102,12,Team Random Map
370543,TheVeryFish,2057,2141,CZ,155,97,58,1,Team Random Map
272166,whitebread61,2060,2140,US,212,139,73,7,Team Random Map
961262,Josefromspain,2061,2140,US,240,151,89,20,Team Random Map
355035,currycurry,2088,2138,SE,158,84,74,2,Team Random Map
316834,FishCakes,2106,2135,US,209,124,85,5,Team Random Map
269205,Phenytoin,2110,2134,AU,255,172,83,5,Team Random Map
274130,BIGDADDY,2133,2132,FR,195,114,81,2,Team Random Map
230592,打蝦小,2155,2131,TW,112,58,54,2,Team Random Map
1439621,The Rohirrim,2160,2131,AU,145,79,66,1,Team Random Map
213715,帥左岸,2165,2130,TW,106,53,53,0,Team Random Map
232952,archib_ld,2178,2129,MU,190,116,74,7,Team Random Map
251340,Revenge,2188,2128,IT,46,29,17,1,Team Random Map
1415080,Bossid,2194,2128,EE,170,101,69,2,Team Random Map
1655898,[KM]FrosT,2229,2125,CL,235,129,106,7,Team Random Map
309422,monoscout999,2239,2124,AR,195,113,82,7,Team Random Map
541547,Philoepe [GER],2255,2122,DE,106,69,37,1,Team Random Map
234095,lMercyAOE,2271,2120,AR,124,79,45,3,Team Random Map
293743,Marthyn,2278,2120,AR,90,60,30,3,Team Random Map
2423861,湖南第一突破口,2307,2116,CN,58,34,24,0,Team Random Map
40856,CheeseKing,2310,2115,CH,262,151,111,3,Team Random Map
1965681,Zeive,2331,2114,ES,213,116,97,7,Team Random Map
426007,TheGrashopper,2336,2113,NL,91,67,24,2,Team Random Map
327782,Icarium Rage,2339,2113,AU,305,167,138,13,Team Random Map
1124892,不会塔爆,2354,2111,CN,324,149,175,25,Team Random Map
263902,Douko,2356,2111,AR,133,94,39,4,Team Random Map
1376313,Mojo jojo,2363,2111,TR,729,366,363,60,Team Random Map
976625,flowaway4,2373,2109,CH,415,254,161,34,Team Random Map
408580,The_American,2376,2109,US,217,112,105,9,Team Random Map
2526695,_63_GuAsOn_Arg,2378,2109,AR,26,22,4,0,Team Random Map
1848728,yago,2380,2109,ES,199,97,102,5,Team Random Map
1093942,BerserkPaladin,2382,2108,US,360,174,186,12,Team Random Map
902557,Grootmeester,2396,2107,NL,293,197,96,8,Team Random Map
785786,Monty,2407,2105,ES,137,91,46,2,Team Random Map
290453,Dott_Berlu,2421,2104,IT,67,50,17,2,Team Random Map
1882768,Mad Dog,2486,2097,CA,268,140,128,15,Team Random Map
350401,伊藤さん,2531,2092,CN,47,36,11,2,Team Random Map
317110,Lazy_man,2533,2092,CN,277,133,144,6,Team Random Map
769600,Yosaii,2543,2090,FR,303,153,150,16,Team Random Map
405175,Al-Iskander,2567,2087,MX,383,236,147,13,Team Random Map
2003630,chap1nziiiin,2579,2085,GT,128,80,48,9,Team Random Map
1971194,Argi,2611,2082,ES,116,79,37,0,Team Random Map
403294,Arqb | Shivansh,2641,2079,IN,159,95,64,12,Team Random Map
280228,Tigry,2650,2077,DE,231,129,102,4,Team Random Map
230085,Marcio Junior,2656,2077,BR,574,316,258,8,Team Random Map
215410,fine thank you,2670,2076,CN,269,167,102,9,Team Random Map
211468,a220541515,2687,2072,TW,148,91,57,1,Team Random Map
1030879,aegus,2699,2071,BE,82,54,28,0,Team Random Map
287230,Burelés,2702,2071,ES,96,65,31,3,Team Random Map
42165,RaptusSangheili,2703,2070,DE,123,77,46,2,Team Random Map
469885,Dioblo,2704,2070,BR,348,187,161,16,Team Random Map
1839507,SasartLeBoss,2706,2070,BE,26,18,8,4,Team Random Map
1563274,Karabas,2707,2070,UA,222,127,95,7,Team Random Map
540324,Tk™ El Stereo,2715,2069,CO,242,137,105,6,Team Random Map
2149041,DaRs | Cambalache_,2717,2069,AR,75,47,28,1,Team Random Map
1394942,nightstalker53,2719,2069,US,128,82,46,2,Team Random Map
214278,Templar,2722,2068,BR,269,150,119,4,Team Random Map
9605,ibawly,2728,2068,CN,163,91,72,11,Team Random Map
275589,AceW,2729,2067,DE,456,243,213,12,Team Random Map
519968,boda_do_age,2740,2066,BR,238,117,121,11,Team Random Map
457389,Sandalen,2741,2066,NO,66,53,13,1,Team Random Map
624644,Holland,2747,2065,NL,92,79,13,3,Team Random Map
1934042,Abyss Vandzy,2772,2063,NA,400,236,164,50,Team Random Map
228855,TradeR,2776,2062,ES,292,161,131,14,Team Random Map
2263883,[31] EnjoyLonely,2785,2060,HK,190,94,96,11,Team Random Map
360208,ZerunBeer,2796,2059,BR,266,140,126,2,Team Random Map
525886,FREESTYLE SCiENTiST,2832,2055,US,45,33,12,6,Team Random Map
1319221,TheDiaper,2845,2053,CA,193,125,68,6,Team Random Map
505787,noobsmile,2855,2052,VN,245,137,108,5,Team Random Map
364342,h4shr,2860,2052,TR,158,102,56,2,Team Random Map
684278,抹茶巧克力,2889,2048,US,354,156,198,5,Team Random Map
874982,伯父,2901,2047,HK,328,170,158,11,Team Random Map
2520659,meme,2915,2046,US,155,91,64,5,Team Random Map
1721120,TomasRu,2927,2044,AR,85,54,31,5,Team Random Map
260786,Logan,2931,2043,PL,198,128,70,4,Team Random Map
214095,Scherom,2961,2039,CH,106,72,34,0,Team Random Map
2126902,LiLi,2967,2039,TR,233,124,109,2,Team Random Map
217354,FoX,2992,2036,AR,229,136,93,9,Team Random Map
409680,LEEEROY JEEENKINS!!!,3037,2030,US,126,85,41,0,Team Random Map
231489,Tiến Sĩ Lê Thành Sách,3059,2028,VN,71,54,17,2,Team Random Map
236944,Zbysio,3078,2026,PL,344,198,146,10,Team Random Map
1077165,Dark,3087,2025,US,94,68,26,0,Team Random Map
1631354,Wormwood,3108,2024,US,318,160,158,7,Team Random Map
1401812,Xerxes,3162,2018,FR,269,143,126,34,Team Random Map
2624148,Tigger King,3181,2016,AR,46,33,13,2,Team Random Map
78611,Joanel,3188,2015,AR,115,67,48,5,Team Random Map
233981,flo.menacher,3191,2015,DE,73,46,27,0,Team Random Map
1746140,54803287,3199,2015,CN,232,115,117,11,Team Random Map
404892,uppsalamala,3204,2014,US,46,31,15,2,Team Random Map
816910,ToNyBaNaNaNa,3212,2013,NL,249,132,117,0,Team Random Map
778801,Frrock,3218,2012,US,313,189,124,6,Team Random Map
2094035,紅色9,3244,2009,BE,23,17,6,0,Team Random Map
860011,mrprov,3255,2007,IT,154,82,72,1,Team Random Map
209432,PingPongCirc,3280,2006,CA,142,90,52,3,Team Random Map
242461,BigAl,3298,2004,US,223,146,77,4,Team Random Map
1627373,Scy,3324,2001,BG,358,169,189,8,Team Random Map
620610,DuDi,3348,1997,PL,173,107,66,12,Team Random Map
403359,BossRice,3363,1996,VN,294,172,122,16,Team Random Map
2301645,inmortalZ,3364,1996,ES,141,89,52,10,Team Random Map
1743862,☺ As$isT.,3371,1995,SI,599,247,352,4,Team Random Map
2509215,Digger,3387,1993,GB,57,44,13,0,Team Random Map
1810707,IamJeo,3435,1989,FI,24,19,5,1,Team Random Map
1594806,Vazilin,3436,1989,DE,184,102,82,6,Team Random Map
707876,Ace_alpo,3440,1988,US,150,88,62,0,Team Random Map
325596,prankill,3449,1988,US,519,250,269,2,Team Random Map
1156148,nassaofsky,3452,1987,BR,77,51,26,2,Team Random Map
1919556,Héos,3465,1986,FR,386,211,175,11,Team Random Map
584612,KingofManzairra,3473,1985,CA,230,134,96,5,Team Random Map
1042305,[AiR] LasseTSG,3508,1980,DE,328,175,153,4,Team Random Map
596642,Benjaaam,3513,1980,FR,154,85,69,3,Team Random Map
536263,bosaap12,3538,1978,NL,273,144,129,18,Team Random Map
2449838,_悟空_WuKong,3542,1978,CN,52,41,11,0,Team Random Map
2202329,Ser Chris,3544,1978,DE,155,91,64,0,Team Random Map
1805906,urki,3599,1973,SI,160,88,72,16,Team Random Map
1741565,Neza___,3619,1971,MX,37,25,12,1,Team Random Map
2188446,どるみーる,3636,1969,JP,70,53,17,0,Team Random Map
1722459,Dr_Scrotus,3649,1968,DE,41,25,16,0,Team Random Map
284002,zm,3650,1967,US,354,208,146,10,Team Random Map
953623,BYD1211,3652,1967,HK,361,182,179,6,Team Random Map
2198171,MonkRock,3663,1967,AU,241,112,129,7,Team Random Map
1650931,BAHAE,3677,1966,MA,24,17,7,1,Team Random Map
842087,Shellrock,3696,1964,CH,85,54,31,1,Team Random Map
1938411,Apostate,3703,1964,SI,198,124,74,11,Team Random Map
242555,Herzog der Normandie,3711,1963,DE,357,215,142,39,Team Random Map
1161881,Jwrg,3739,1960,CN,265,116,149,45,Team Random Map
2132771,Biohazard,3747,1959,CH,95,65,30,0,Team Random Map
422790,gn02239542,3757,1958,TW,341,166,175,6,Team Random Map
226549,Bulbuci,3759,1958,RO,67,38,29,1,Team Random Map
314433,Minjammben,3797,1955,US,177,101,76,1,Team Random Map
216121,LightKnightRob,3809,1954,DE,236,128,108,4,Team Random Map
2445213,WhiteBird,3815,1953,ES,54,38,16,0,Team Random Map
212159,Runnin_Gag,3823,1952,CH,203,118,85,12,Team Random Map
384906,RTK{S} | viscoussatsuma,3826,1952,GB,153,91,62,3,Team Random Map
1747909,duckdowN,3839,1951,BR,151,80,71,2,Team Random Map
312167,Daniel Kon,3858,1949,US,42,30,12,0,Team Random Map
592729,nirovaka,3872,1947,NO,293,149,144,7,Team Random Map
269503,cackle_,3899,1945,US,72,56,16,0,Team Random Map
2352845,Borisat,3910,1944,CO,60,28,32,5,Team Random Map
892634,AutoKarL,3918,1943,CL,230,114,116,1,Team Random Map
250184,Zeck,3930,1942,FR,124,81,43,6,Team Random Map
539495,3ScarFac3,3964,1939,DE,201,104,97,0,Team Random Map
1553006,Bahazhor,3982,1938,BR,295,142,153,8,Team Random Map
977385,KARVEN,3994,1936,TR,301,146,155,5,Team Random Map
2262048,Spider Cop,4011,1935,TR,76,51,25,3,Team Random Map
2051708,Schiggy,4012,1935,CA,110,49,61,2,Team Random Map
404310,VOLVO22,4027,1933,US,71,39,32,4,Team Random Map
1264020,Isabella,4031,1933,DE,97,70,27,4,Team Random Map
1176082,FLAVIUS__AETIUS,4032,1932,GR,284,157,127,5,Team Random Map
1925652,Unaerodof,4055,1931,RO,66,36,30,0,Team Random Map
2114185,VIPN@U,4095,1927,VN,87,54,33,3,Team Random Map
609696,[AOG]Oppy96,4130,1924,ES,282,160,122,6,Team Random Map
1963663,neverdowngogogo,4153,1922,CA,159,89,70,7,Team Random Map
1363750,netavoise(fr),4157,1922,FR,119,66,53,4,Team Random Map
283029,Monsieur Verdoux,4168,1920,DE,83,63,20,0,Team Random Map
401440,qwertyman,4172,1920,AU,318,164,154,5,Team Random Map
1383558,Legion of Boom,4175,1920,AU,95,65,30,1,Team Random Map
1866331,HeKooro,4184,1919,NO,284,129,155,65,Team Random Map
1702816,Clouclou666,4187,1919,FR,125,77,48,3,Team Random Map
1491062,Paterlocco,4188,1919,NL,248,128,120,7,Team Random Map
578428,Blue,4216,1916,GB,119,59,60,1,Team Random Map
517650,Bobby.B.Brunno,4218,1916,CZ,330,191,139,2,Team Random Map
376789,schopeng,4236,1915,DE,321,207,114,29,Team Random Map
2483687,EasyGame,4245,1914,HK,55,32,23,0,Team Random Map
37064,Dellzeraaa,4252,1913,BR,164,94,70,4,Team Random Map
793776,GrimorG,4284,1911,FR,379,226,153,8,Team Random Map
510506,Ger2107,4286,1911,ES,406,199,207,6,Team Random Map
234806,Gazerbeam,4287,1911,DE,135,70,65,4,Team Random Map
1000735,Angst Potter,4296,1910,DE,352,160,192,13,Team Random Map
423208,Francescam,4348,1906,FR,224,134,90,24,Team Random Map
223492,Hacher23,4350,1906,ES,314,163,151,3,Team Random Map
93040,Yadsmood,4383,1903,TW,31,22,9,1,Team Random Map
1085218,MicKey,4415,1900,DE,151,89,62,5,Team Random Map
255233,queronte,4417,1900,CL,62,47,15,2,Team Random Map
1493610,Dr Loom,4431,1900,US,81,53,28,0,Team Random Map
252660,CitizenAbel,4434,1899,DE,66,52,14,2,Team Random Map
2320426,Mginner,4464,1897,MX,80,47,33,1,Team Random Map
372514,Lewis El Sucio,4514,1893,GB,150,91,59,0,Team Random Map
2267133,白腳黑貓,4515,1893,TW,232,114,118,7,Team Random Map
2030683,VICE PRESIDENT MIKE PENCE,4517,1893,GB,56,41,15,2,Team Random Map
2643094,Argos,4525,1892,AR,29,14,15,2,Team Random Map
338588,Khal Kamsma,4542,1891,NL,282,146,136,12,Team Random Map
95369,RIBBEN,4558,1889,BE,383,222,161,13,Team Random Map
493574,Death0rGlory,4575,1888,DE,117,88,29,3,Team Random Map
307225,crooksnm,4582,1888,US,130,73,57,4,Team Random Map
1863775,Blueden,4610,1886,CN,32,23,9,2,Team Random Map
1848121,Samplify,4622,1885,US,141,85,56,2,Team Random Map
546202,Bourbon Jr.,4653,1882,SA,34,25,9,0,Team Random Map
614778,Wurschti [030er],4676,1880,DE,312,142,170,16,Team Random Map
1927980,roulette,4680,1880,TR,287,147,140,7,Team Random Map
1540393,konnitheking,4730,1875,DE,145,90,55,7,Team Random Map
1172553,WololoWitek,4746,1873,PL,272,147,125,6,Team Random Map
942382,Simon,4768,1872,DE,229,123,106,8,Team Random Map
223624,[Fc],4773,1872,BO,156,95,61,4,Team Random Map
370805,XelVic,4783,1871,DE,148,99,49,3,Team Random Map
222365,Akers,4795,1870,US,183,104,79,3,Team Random Map
2445906,Jacques Lacan,4824,1868,DE,143,80,63,7,Team Random Map
634497,Card7,4837,1867,AR,228,111,117,1,Team Random Map
256937,TheHound,4867,1865,DE,318,164,154,5,Team Random Map
482295,假球卡王姆,4868,1865,HK,124,67,57,1,Team Random Map
2595751,Moctezuma,4871,1865,FR,111,59,52,5,Team Random Map
2211446,Taymour,4872,1865,CA,34,11,23,0,Team Random Map
253973,The Chancellor,4881,1864,GB,231,135,96,8,Team Random Map
1578367,hamza.asif95,4904,1863,AR,146,89,57,10,Team Random Map
2431776,ItsOver9000,4924,1861,AR,19,15,4,0,Team Random Map
1233083,Coach,4953,1860,AR,85,47,38,3,Team Random Map
913524,Mathrandil,4957,1859,DE,74,49,25,0,Team Random Map
266653,GWC_Roadrunner,4958,1859,DE,106,64,42,2,Team Random Map
458070,[KM]_Lechuga Asesina,4964,1859,CL,32,23,9,1,Team Random Map
2694118,Saunder,4965,1859,AR,32,24,8,0,Team Random Map
1079878,Docta Cheese,4982,1857,US,137,74,63,3,Team Random Map
2335962,Vailean,4991,1857,CA,238,126,112,7,Team Random Map
627899,brkataman,4999,1856,TR,89,62,27,0,Team Random Map
219108,Volrath,5036,1854,CO,265,139,126,14,Team Random Map
1867951,reeNN;b  «XJ.SPANISH»,5048,1853,DE,84,50,34,1,Team Random Map
302570,Arafat,5053,1853,AR,161,104,57,6,Team Random Map
1414997,TaylorSwift.<3,5066,1852,US,155,85,70,9,Team Random Map
2294295,MACACO SUPREMO,5087,1850,BR,61,45,16,1,Team Random Map
865016,BillaBamZilla,5095,1849,AE,283,158,125,8,Team Random Map
843735,Parlorage,5131,1846,FR,130,77,53,12,Team Random Map
2397822,Pallamoto,5133,1846,TR,106,64,42,4,Team Random Map
352111,伐伐伐伐伐木工,5135,1846,TW,150,70,80,5,Team Random Map
2449230,Sinful,5150,1845,CA,193,102,91,0,Team Random Map
1322487,PlusEV,5154,1845,DE,407,217,190,3,Team Random Map
227410,✘˵╹◡╹˶✘,5181,1843,FI,103,62,41,0,Team Random Map
2304691,sace_do_age,5185,1843,BR,103,53,50,0,Team Random Map
222385,-KiMOsaBE-,5199,1842,DE,190,108,82,5,Team Random Map
216652,Lachie,5206,1842,AU,345,163,182,3,Team Random Map
2361876,nailien,5216,1841,GB,11,9,2,1,Team Random Map
379384,JacoB,5225,1840,CZ,218,110,108,13,Team Random Map
2281770,Lorenzo de' Medici,5227,1840,US,256,129,127,2,Team Random Map
1298860,SABIIIIIIIIII,5233,1840,FR,111,60,51,0,Team Random Map
2653326,PhantasticPhil,5259,1838,AT,22,18,4,0,Team Random Map
270669,Franzeppo,5262,1837,AR,31,25,6,1,Team Random Map
267986,Yansonic,5263,1837,CL,172,96,76,4,Team Random Map
985630,BaronAoe,5275,1836,TR,116,68,48,7,Team Random Map
500274,BonanaKing,5279,1836,SE,85,62,23,0,Team Random Map
491712,Atlas,5282,1836,DK,252,130,122,4,Team Random Map
248311,Belle-couille,5301,1834,FR,15,13,2,0,Team Random Map
2321523,jessefakinjeyms,5317,1833,TR,208,102,106,2,Team Random Map
195408,ChampionRevolution,5323,1833,TW,171,100,71,10,Team Random Map
644309,LouDELARCHE,5327,1832,NA,449,224,225,17,Team Random Map
437806,SmokizzMTL,5330,1832,NA,389,203,186,14,Team Random Map
1817704,明月千堆雪,5333,1832,CN,341,156,185,8,Team Random Map
771501,Pierretto,5339,1831,CH,173,95,78,9,Team Random Map
338996,NaNoseKunda,5351,1831,CZ,359,167,192,13,Team Random Map
2531022,Yafes,5360,1830,TR,183,95,88,2,Team Random Map
1926454,14,5365,1830,TW,61,43,18,1,Team Random Map
330481,gil,5368,1830,AU,175,95,80,9,Team Random Map
246031,Jabob,5395,1828,DE,329,199,130,8,Team Random Map
580425,Oranje,5396,1828,DE,184,101,83,2,Team Random Map
2590992,GT_22,5402,1828,AR,11,9,2,1,Team Random Map
304510,Vicebu,5425,1827,CA,419,189,230,10,Team Random Map
278820,Uprootednut,5428,1826,GB,125,71,54,1,Team Random Map
992631,jaylin700110,5429,1826,TW,60,46,14,1,Team Random Map
1715442,ObtuseHawk,5459,1825,US,60,38,22,0,Team Random Map
1756665,mesutbakirci91,5475,1824,TR,221,131,90,7,Team Random Map
1890141,Svriz,5489,1823,CL,218,116,102,5,Team Random Map
606780,TestosteroneRAGE,5503,1822,CA,242,140,102,9,Team Random Map
553794,sunsetflyer,5517,1821,US,69,39,30,0,Team Random Map
671783,FenixMexicano,5535,1820,MX,80,50,30,1,Team Random Map
739397,UnionStrike,5563,1818,IT,167,94,73,8,Team Random Map
2075973,VN_THoMaS,5568,1818,ES,120,87,33,5,Team Random Map
1839036,Wayman92,5597,1816,DE,50,35,15,0,Team Random Map
1473663,Edorsa,5600,1816,TR,119,73,46,2,Team Random Map
1063725,Indemonkable,5602,1815,US,381,191,190,10,Team Random Map
771735,Ray-Ray 火,5622,1814,BG,384,187,197,11,Team Random Map
895514,Fabián,5639,1813,CR,142,92,50,2,Team Random Map
613999,]AtF[  DaDumbazz O.o,5640,1813,CA,84,70,14,0,Team Random Map
1812818,Mush,5654,1813,HU,74,46,28,0,Team Random Map
300565,Wean Dinchester,5657,1813,DE,333,179,154,13,Team Random Map
947019,HeuristicMagic,5662,1812,US,177,100,77,1,Team Random Map
635875,rua！,5665,1812,CN,173,115,58,6,Team Random Map
1743347,FenixooEM,5675,1812,NA,130,81,49,4,Team Random Map
874335,DonnieMack,5679,1811,AU,152,72,80,2,Team Random Map
644738,legia92,5681,1811,BE,285,142,143,12,Team Random Map
2641056,Horny Rabbit,5684,1811,AE,85,57,28,3,Team Random Map
261278,All Reilled Up,5717,1808,GB,150,84,66,2,Team Random Map
253068,shanavii,5718,1808,PL,91,58,33,4,Team Random Map
1425115,ATATURK,5729,1808,RU,256,136,120,3,Team Random Map
901674,deebsy,5731,1807,GB,66,47,19,1,Team Random Map
323379,Kaos,5759,1806,AU,85,57,28,1,Team Random Map
281737,Vertical Vertigo,5764,1805,CA,39,28,11,1,Team Random Map
358370,Faultier321,5788,1804,DE,23,19,4,0,Team Random Map
2329473,Ryszko,5804,1803,HU,38,27,11,1,Team Random Map
303416,TopDownKnight,5823,1802,US,302,148,154,4,Team Random Map
468386,Tom Jobim,5830,1801,BR,173,96,77,10,Team Random Map
1773354,七張米粉湯,5887,1798,TW,147,82,65,1,Team Random Map
348832,TurdSandwich,5917,1796,BE,228,128,100,8,Team Random Map
1477239,noname8135,5935,1795,TW,48,32,16,2,Team Random Map
594754,Captain_Jacky,5950,1793,IN,177,99,78,10,Team Random Map
2518590,I<3Militia,5975,1792,DE,44,25,19,0,Team Random Map
82816,Andrexdx,5992,1791,BR,169,91,78,3,Team Random Map
2310774,fredyr45,5997,1791,CO,63,34,29,1,Team Random Map
210551,LitvinovII,6018,1789,MX,191,104,87,4,Team Random Map
233176,Eddy,6019,1789,AL,34,22,12,0,Team Random Map
1921533,Laca Sensual,6045,1788,AR,161,84,77,13,Team Random Map
282125,AkhiE,6054,1787,FR,215,121,94,3,Team Random Map
2541112,lube the kid,6089,1786,ES,33,21,12,0,Team Random Map
272531,sacroima,6121,1784,CH,117,82,35,1,Team Random Map
69273,G-shock,6125,1784,TW,332,169,163,5,Team Random Map
1770697,chino1339,6155,1783,ES,645,352,293,11,Team Random Map
913154,evgeny93,6160,1782,IL,37,26,11,0,Team Random Map
2176958,snackerino,6172,1782,DE,103,66,37,2,Team Random Map
2434658,gp1991,6185,1781,GB,38,32,6,1,Team Random Map
725112,Nate The Noob,6195,1780,US,14,9,5,0,Team Random Map
244983,Risa0712,6226,1778,HK,61,35,26,1,Team Random Map
2061131,Jesse Pinkman,6233,1778,CL,49,32,17,3,Team Random Map
218883,Echte,6236,1778,FR,39,28,11,1,Team Random Map
1086258,Teiiko,6259,1776,FR,302,171,131,11,Team Random Map
229224,Knight_eater,6261,1776,DE,122,78,44,2,Team Random Map
223262,Buntar',6266,1776,LV,51,40,11,0,Team Random Map
1021599,voblivion,6304,1773,CA,53,33,20,0,Team Random Map
472600,Formaggio,6325,1772,AU,118,67,51,5,Team Random Map
2365106,Weevers_,6327,1772,FR,34,26,8,1,Team Random Map
1901343,TangoZoulou,6329,1772,CH,372,170,202,17,Team Random Map
230198,Acces,6345,1771,DE,392,194,198,7,Team Random Map
590036,Kesakoo,6379,1769,VN,214,106,108,20,Team Random Map
1507571,Frietback,6392,1769,NL,38,28,10,0,Team Random Map
1539864,3077610,6419,1768,ES,42,33,9,0,Team Random Map
210855,M4lt3,6432,1767,DE,162,103,59,8,Team Random Map
393166,PudelDesTodes,6439,1767,DE,12,10,2,0,Team Random Map
1840657,Craidon,6459,1766,CO,230,113,117,4,Team Random Map
691826,Lucky,6472,1765,AT,226,113,113,5,Team Random Map
1476368,M4rc3l90,6480,1765,DE,154,86,68,10,Team Random Map
282707,Tao,6482,1764,DE,128,79,49,1,Team Random Map
166935,pFunk,6517,1762,AR,62,49,13,0,Team Random Map
388611,nachoforlano,6524,1762,AR,78,48,30,2,Team Random Map
206231,Пюреха,6530,1761,RU,302,139,163,2,Team Random Map
372041,Ten of Clubs,6582,1758,FR,248,138,110,3,Team Random Map
615163,᠌Lambes,6614,1756,BR,112,67,45,3,Team Random Map
2156541,Evilzer,6636,1755,BR,54,35,19,0,Team Random Map
2504771,harmanpreet0,6654,1754,CA,47,33,14,1,Team Random Map
1699118,_Awesomenoob,6657,1754,AT,27,20,7,1,Team Random Map
1191728,TheSlim3,6660,1754,US,226,125,101,2,Team Random Map
700079,Badaxer,6665,1753,FR,205,105,100,5,Team Random Map
212645,fencer1509,6688,1752,DE,314,154,160,4,Team Random Map
574143,Charles V le Sage,6692,1752,FR,231,127,104,6,Team Random Map
2040065,johneigner,6698,1752,DE,54,33,21,3,Team Random Map
660213,Lohabquas,6715,1751,HR,28,14,14,0,Team Random Map
998840,Irony,6734,1750,AU,202,105,97,3,Team Random Map
2624307,Jahikoi,6758,1749,AU,40,21,19,0,Team Random Map
2272397,Whoops,6760,1749,AU,113,62,51,2,Team Random Map
313785,"yeah,iam NB",6765,1749,CN,269,134,135,10,Team Random Map
278580,Frysez,6768,1748,NL,157,88,69,2,Team Random Map
827454,Drac- Charles,6772,1748,MX,604,339,265,21,Team Random Map
512949,Cajita Feliz,6775,1748,CL,64,41,23,1,Team Random Map
537486,Snikolay,6802,1747,NL,88,57,31,1,Team Random Map
1808121,Negrev,6816,1747,AR,194,100,94,5,Team Random Map
285635,Idaguy,6823,1746,CA,229,116,113,3,Team Random Map
224474,deev,6836,1746,US,167,91,76,1,Team Random Map
1657869,makkummee,6837,1746,FI,110,63,47,3,Team Random Map
2329851,Perseus,6865,1744,IN,158,91,67,4,Team Random Map
265901,Pessimistic Guy,6875,1743,AT,180,118,62,10,Team Random Map
246540,Keukenschaar,6903,1742,BE,98,56,42,6,Team Random Map
425419,Axiom,6911,1742,CA,269,143,126,6,Team Random Map
1904881,thehawkman,6935,1741,US,158,88,70,4,Team Random Map
386571,Go-Toba,6949,1740,GB,82,57,25,2,Team Random Map
209885,Guardian Azul,6967,1739,MX,207,110,97,3,Team Random Map
1702377,Turks 1 Trick,6977,1739,US,119,62,57,2,Team Random Map
1239541,Faja,6980,1739,BE,277,147,130,7,Team Random Map
1349498,Thomas92,6992,1738,FR,73,51,22,7,Team Random Map
257469,lordzaamus,6995,1737,IT,270,140,130,8,Team Random Map
231547,bigbossbro08,7022,1736,AR,14,10,4,1,Team Random Map
311953,(TT)ADREK,7034,1736,MX,91,57,34,3,Team Random Map
518920,CoK_a_cola,7044,1735,DE,176,107,69,4,Team Random Map
507548,melvin,7045,1735,US,16,10,6,0,Team Random Map
2348228,luk,7074,1733,DE,89,47,42,2,Team Random Map
354755,-DoCa- RageMan,7096,1732,NL,70,33,37,2,Team Random Map
222022,Kusihe,7097,1732,FR,130,83,47,7,Team Random Map
241647,Mibis,7118,1731,TR,230,116,114,6,Team Random Map
1077816,VicXiaoQ5!,7133,1730,AR,271,146,125,13,Team Random Map
229702,xxEGCxx,7141,1730,MX,75,38,37,6,Team Random Map
266053,Snicklerdoodle,7155,1729,NA,35,29,6,0,Team Random Map
1508557,Carrey,7187,1728,FI,121,79,42,2,Team Random Map
1770837,无言,7204,1727,CN,10,10,0,0,Team Random Map
1153965,porotos con rienda,7209,1726,CL,224,117,107,13,Team Random Map
283465,Shakuni,7210,1726,US,46,32,14,1,Team Random Map
853553,Cloud,7212,1726,AU,111,70,41,10,Team Random Map
373131,Cinderella,7220,1726,AT,121,54,67,6,Team Random Map
1940208,Drey,7223,1726,FR,45,35,10,1,Team Random Map
1765918,good ol' Malt,7224,1726,DE,35,24,11,0,Team Random Map
1899786,johnny23467,7267,1724,TW,290,132,158,13,Team Random Map
1286478,Vasiliy II,7274,1724,UA,261,138,123,6,Team Random Map
662937,Sterling,7275,1723,IT,62,41,21,3,Team Random Map
2104877,GdaFrekka,7281,1723,CH,488,221,267,6,Team Random Map
2118427,supersuperslu,7305,1722,GB,171,87,84,1,Team Random Map
216839,HartzFear,7311,1722,DE,312,164,148,1,Team Random Map
1252576,knightman,7329,1721,AU,141,82,59,3,Team Random Map
1168248,tyfong311,7330,1720,HK,52,32,20,0,Team Random Map
396414,Morh,7339,1720,ES,464,242,222,13,Team Random Map
837131,zukarii-,7350,1719,NL,131,88,43,4,Team Random Map
624437,ölfysn,7370,1718,DE,83,48,35,0,Team Random Map
223002,edpzdn,7380,1718,TR,215,122,93,3,Team Random Map
740532,fuLvo ✮,7392,1717,BR,44,30,14,0,Team Random Map
218068,[KGR]Mustang,7410,1717,DE,57,45,12,0,Team Random Map
853383,larsgillo1401,7434,1715,AU,73,47,26,2,Team Random Map
214758,OleBambole,7470,1713,DE,138,86,52,9,Team Random Map
2680626,TrollingHard,7479,1713,US,134,67,67,3,Team Random Map
1105680,YOUrBADimMAD,7490,1712,DE,167,92,75,4,Team Random Map
1285622,Just Passing,7525,1711,RU,21,17,4,0,Team Random Map
463774,Massito8,7557,1709,UY,39,22,17,1,Team Random Map
1496695,BrokeBack,7568,1709,DE,15,14,1,0,Team Random Map
2404842,hotaco_01,7590,1708,PE,65,41,24,3,Team Random Map
2090140,Khorr,7614,1707,FR,59,35,24,0,Team Random Map
1214846,Mawi,7624,1707,SE,155,74,81,9,Team Random Map
214757,宇智波一达蜀黍,7626,1706,CN,290,149,141,7,Team Random Map
382385,Docteur.NoTime,7639,1706,FR,280,148,132,6,Team Random Map
2473718,Kungenmage,7667,1705,DE,58,33,25,2,Team Random Map
1915149,Pepeje SapéKomJamais,7674,1705,FR,285,140,145,4,Team Random Map
377935,Yo,7693,1704,FR,116,69,47,2,Team Random Map
610102,Answaldomir,7715,1703,AT,120,65,55,1,Team Random Map
703782,Tilmarod,7734,1702,ES,42,29,13,0,Team Random Map
278844,BlancuZ,7763,1701,CR,124,65,59,4,Team Random Map
66197,Zac Power Moon Rider,7775,1701,AU,38,28,10,0,Team Random Map
2391349,Djerbino,7778,1701,FR,137,71,66,3,Team Random Map
221593,Leter Pustig,7782,1701,DE,65,45,20,1,Team Random Map
1931804,luckywick,7783,1701,FR,33,24,9,0,Team Random Map
269982,master toast,7814,1699,DE,126,74,52,1,Team Random Map
441227,Korean BBQ,7818,1699,AR,273,137,136,8,Team Random Map
297533,4rk.V0n,7825,1699,CN,78,44,34,10,Team Random Map
2329388,Marble Liu,7844,1698,TW,70,43,27,2,Team Random Map
208812,GriN,7886,1696,RU,20,15,5,1,Team Random Map
1778379,404,7888,1696,IN,115,64,51,3,Team Random Map
2018599,El_churrete,7910,1695,AR,74,45,29,3,Team Random Map
1978419,Itani,7911,1695,BR,55,29,26,5,Team Random Map
289559,Dr.EddyG,7936,1694,US,43,33,10,1,Team Random Map
1127854,Tinuu,7938,1693,CH,110,60,50,1,Team Random Map
239329,Nagaraj226,7948,1693,IN,86,50,36,5,Team Random Map
1790613,Mitya. Acyclical. Cohomology.,7960,1693,US,146,84,62,4,Team Random Map
283554,Monkey Boy,7965,1692,DE,29,22,7,0,Team Random Map
79786,JaMa42,7971,1692,DE,41,29,12,1,Team Random Map
1055432,Sun,8022,1690,CZ,15,14,1,1,Team Random Map
695416,小江南,8027,1690,CN,215,105,110,5,Team Random Map
593900,Flying Weasel,8031,1690,AU,150,71,79,2,Team Random Map
225832,Baysal,8040,1690,TR,179,93,86,3,Team Random Map
1404067,Kyrios,8049,1690,DE,104,55,49,3,Team Random Map
272825,PurgeFIN,8053,1689,FI,244,135,109,2,Team Random Map
701051,MarcoPolo,8055,1689,AT,178,94,84,2,Team Random Map
2315877,Gracchus,8062,1689,DE,41,18,23,1,Team Random Map
1383788,paulovmcm,8067,1689,BR,81,39,42,13,Team Random Map
287125,Ratzointzoin,8071,1689,FR,222,111,111,6,Team Random Map
211503,YertleTheTurtle,8104,1687,NL,104,60,44,0,Team Random Map
236245,BlaueTomate,8108,1687,DE,109,73,36,3,Team Random Map
1920975,Botzanga,8124,1687,MX,152,79,73,8,Team Random Map
238759,benjamin_esteban,8140,1686,CL,69,42,27,3,Team Random Map
338904,TactX,8205,1684,BE,244,130,114,12,Team Random Map
266995,Mr. Dziks,8217,1683,PL,243,117,126,9,Team Random Map
257292,Degaussed,8220,1683,GB,115,67,48,0,Team Random Map
1779707,tony122597,8243,1683,MO,593,270,323,32,Team Random Map
1014467,xxjacexx1,8249,1682,PL,266,125,141,3,Team Random Map
437112,Schubert,8262,1682,TW,81,53,28,6,Team Random Map
375354,TimmeahNL,8266,1682,NL,99,67,32,1,Team Random Map
300618,Szyly,8299,1681,HU,173,74,99,2,Team Random Map
276948,swigers,8303,1680,CH,75,45,30,2,Team Random Map
1577906,pekkakana,8316,1680,FI,99,63,36,3,Team Random Map
1353415,Yoda17,8319,1680,FR,258,147,111,8,Team Random Map
94056,Jon,8343,1678,DE,24,18,6,0,Team Random Map
2372863,mtrx_ upgrade.gg,8354,1678,BR,73,41,32,3,Team Random Map
1536575,Fleischwolf,8386,1677,DE,32,25,7,0,Team Random Map
2537882,KsHulO,8398,1676,CL,130,78,52,5,Team Random Map
394682,Prof. Dr. Acula,8420,1675,DE,158,88,70,11,Team Random Map
1112400,AngelFaust,8459,1673,US,59,29,30,1,Team Random Map
1206757,Lazrick,8480,1673,CA,363,180,183,5,Team Random Map
2062279,serei,8495,1672,DE,64,46,18,0,Team Random Map
219280,Phoenix,8524,1671,CN,166,92,74,11,Team Random Map
1677858,Heavensrage,8525,1671,US,219,110,109,2,Team Random Map
1565272,Trumpitrampeltier,8553,1670,AT,123,73,50,5,Team Random Map
1470056,Alexsieflexi,8555,1670,NA,156,85,71,5,Team Random Map
721771,Diheadwarlord,8589,1668,US,233,122,111,5,Team Random Map
2304981,IErtugrul BeyI,8600,1668,TR,122,67,55,0,Team Random Map
2202588,yenky,8627,1667,DK,196,98,98,8,Team Random Map
1186494,Raptoriwori,8640,1667,NL,156,85,71,6,Team Random Map
836578,USTAD,8645,1666,TR,186,87,99,7,Team Random Map
713253,joosepkarp,8651,1666,EE,238,126,112,7,Team Random Map
289158,Nite_Noble24,8668,1666,US,391,194,197,22,Team Random Map
1864872,TU VIEJA,8687,1665,AR,67,44,23,1,Team Random Map
312823,Vindi,8691,1665,US,55,38,17,1,Team Random Map
428665,sack,8703,1664,NZ,212,111,101,10,Team Random Map
1972419,hercko,8760,1662,ES,126,59,67,2,Team Random Map
246121,DarkHoplite,8775,1661,AT,80,45,35,4,Team Random Map
547189,rhapsody,8776,1661,TR,119,65,54,2,Team Random Map
518152,YISITHEGR8,8800,1660,GB,13,9,4,0,Team Random Map
2206591,Menino da porteira,8807,1660,BR,48,28,20,0,Team Random Map
465094,Jagger,8831,1659,AR,78,46,32,6,Team Random Map
287739,Hell Topo,8845,1659,FR,66,41,25,1,Team Random Map
1925545,SOS - Lawrence,8860,1658,TW,10,7,3,0,Team Random Map
1369604,Rudolf,8865,1658,HK,13,7,6,0,Team Random Map
2175394,^^,8882,1657,GB,127,75,52,5,Team Random Map
1260835,GGino,8894,1657,GB,170,93,77,0,Team Random Map
258792,TOAOJCulling,8899,1656,NA,69,43,26,1,Team Random Map
450261,IdleBrain,8957,1654,BR,81,53,28,3,Team Random Map
817575,Æurosswydd,8976,1653,TR,146,90,56,17,Team Random Map
226606,Zorkos,8980,1653,FR,148,86,62,6,Team Random Map
2054789,m.maaz.kamal,8983,1653,US,281,111,170,10,Team Random Map
1633111,Kuurenay,8987,1653,ID,25,24,1,0,Team Random Map
218511,HardNRG,8988,1653,FI,36,24,12,2,Team Random Map
1073158,Juda_the_rabbi,8994,1652,DE,93,53,40,5,Team Random Map
791521,xX † KlötenKarl † Xx,9002,1652,DE,426,210,216,8,Team Random Map
501124,Kenzai,9009,1652,DE,180,98,82,8,Team Random Map
2606172,jeanetkat,9013,1652,BE,22,15,7,2,Team Random Map
207721,BadMaru,9019,1652,BR,200,100,100,5,Team Random Map
238961,pEp,9032,1651,ES,117,82,35,2,Team Random Map
1902288,crc757,9040,1651,US,66,36,30,0,Team Random Map
1892207,Randalf,9041,1651,DE,28,19,9,0,Team Random Map
32257,teban0721,9042,1651,JP,207,104,103,11,Team Random Map
1753021,ThomJohnson,9043,1651,BE,16,15,1,0,Team Random Map
1685064,khanate@nosound,9045,1651,DE,239,123,116,3,Team Random Map
2556255,jsc,9057,1650,GB,53,34,19,0,Team Random Map
14400,Luffy,9069,1650,IN,136,70,66,6,Team Random Map
302612,Thanatos,9072,1650,US,202,103,99,1,Team Random Map
236878,Jan,9079,1649,DE,154,74,80,0,Team Random Map
770151,CakeMilk,9097,1648,TW,161,91,70,3,Team Random Map
435258,Ammoniumdiuranatpüree,9105,1648,DE,105,60,45,1,Team Random Map
2306540,FireLord,9111,1648,BR,12,9,3,2,Team Random Map
339511,血矢筑,9120,1648,JP,35,20,15,5,Team Random Map
256300,Crassus,9137,1647,DE,43,28,15,0,Team Random Map
292776,goodjunk21,9162,1647,US,67,30,37,5,Team Random Map
2550066,The Kraken,9173,1646,MX,20,13,7,1,Team Random Map
390601,Icyroaster,9174,1646,CH,102,58,44,1,Team Random Map
221900,billiger_jakob,9179,1646,DE,85,52,33,3,Team Random Map
303894,Bono,9185,1646,US,270,138,132,4,Team Random Map
1964726,WetSteak,9210,1645,DE,96,50,46,1,Team Random Map
931203,Drulo,9216,1644,AR,90,57,33,1,Team Random Map
403731,tbaumgardner,9228,1644,US,72,49,23,3,Team Random Map
217871,_hugo,9268,1643,GB,78,49,29,13,Team Random Map
1465183,Jeanne d' Arc,9270,1643,AR,461,221,240,12,Team Random Map
1444824,Vlarham,9271,1643,FR,68,39,29,0,Team Random Map
1427042,Boxxhenizeel,9272,1643,BG,67,34,33,0,Team Random Map
1356734,Camelo04,9273,1643,DE,295,150,145,11,Team Random Map
641225,lemolinator,9282,1642,FR,88,50,38,0,Team Random Map
986574,OnlyplayBristle,9307,1641,US,231,108,123,21,Team Random Map
1840957,Panaxios,9326,1641,GR,145,73,72,8,Team Random Map
541777,LaFlamaBlanca,9340,1640,SE,342,172,170,3,Team Random Map
246839,Lou,9363,1639,FR,92,50,42,3,Team Random Map
1868204,Humanize,9373,1639,BE,110,41,69,0,Team Random Map
1403764,Javi_Venta,9381,1639,UY,128,79,49,4,Team Random Map
2475919,Budweiser,9404,1638,AR,49,33,16,2,Team Random Map
1675954,Nikrendo,9414,1638,NA,132,69,63,12,Team Random Map
1888570,lu.pit,9443,1637,CH,252,119,133,5,Team Random Map
1108829,Mohamed Almorrana,9472,1635,ES,345,169,176,5,Team Random Map
918569,Angryhippo2910,9475,1635,CA,177,84,93,0,Team Random Map
399839,arusttx,9482,1635,US,215,129,86,1,Team Random Map
2477846,Sw3aty LOL,9484,1635,GR,25,13,12,0,Team Random Map
2329057,Honey & Nick,9487,1635,NZ,65,31,34,0,Team Random Map
2359209,Sethmo,9521,1634,DE,63,40,23,3,Team Random Map
2495860,jonathansoegaard,9523,1634,DK,107,61,46,4,Team Random Map
2177743,Labude_aoe,9525,1634,DE,39,28,11,1,Team Random Map
1229328,Mornius,9532,1634,DE,107,60,47,2,Team Random Map
570434,萨米尔鼠标耶夫,9538,1633,CN,149,77,72,8,Team Random Map
426322,DevLord,9545,1633,IN,99,57,42,4,Team Random Map
2360536,13oss,9550,1633,DE,17,15,2,0,Team Random Map
251299,Pas,9574,1632,GB,56,41,15,3,Team Random Map
227328,Luckaffe,9580,1632,DE,28,23,5,1,Team Random Map
327409,DULO,9588,1632,BG,128,66,62,2,Team Random Map
170400,Nightman,9592,1632,US,145,83,62,2,Team Random Map
616203,Son Of Osiris,9606,1631,NA,16,13,3,0,Team Random Map
2327784,nekonomi,9654,1630,JP,30,21,9,1,Team Random Map
2052026,Pointgiven187,9656,1630,US,111,53,58,2,Team Random Map
1065975,Duldran,9670,1629,DE,79,47,32,2,Team Random Map
1057622,Armageddon,9671,1629,CH,15,9,6,0,Team Random Map
260054,Sorteer Meneer,9674,1629,NL,152,85,67,11,Team Random Map
2591989,Sharm,9677,1629,FR,19,16,3,0,Team Random Map
2277814,Keza,9680,1629,CH,113,62,51,2,Team Random Map
2147194,Glantonne,9681,1629,CA,58,34,24,0,Team Random Map
1981742,Fin1887,9682,1629,DE,104,54,50,1,Team Random Map
1079694,ConfusedNigerian,9693,1628,CA,134,60,74,6,Team Random Map
2036169,A L A I N,9709,1628,BE,164,83,81,4,Team Random Map
293288,Bean Dip,9717,1628,US,94,58,36,3,Team Random Map
1958605,JohnnyAc,9737,1627,GP,127,59,68,9,Team Random Map
304228,Cuba,9743,1627,AR,108,58,50,1,Team Random Map
112720,Aquarius XII,9767,1626,DE,87,57,30,3,Team Random Map
774760,_RobinH_,9780,1625,DE,37,29,8,2,Team Random Map
1991092,Unum7,9798,1625,ES,48,34,14,0,Team Random Map
622587,[DoT] Dagorlad,9818,1624,MX,17,13,4,0,Team Random Map
350220,Akgnor,9829,1624,NL,151,88,63,5,Team Random Map
1991202,NCO,9830,1624,FR,72,50,22,1,Team Random Map
1354555,FlipFlopJuuz,9837,1624,DK,33,25,8,0,Team Random Map
810381,adivsb,9845,1623,CN,50,35,15,1,Team Random Map
631491,Couk,9848,1623,AR,169,92,77,7,Team Random Map
1944686,edaba,9867,1623,AR,71,38,33,1,Team Random Map
1693433,LT21,9870,1623,DE,139,76,63,7,Team Random Map
468425,FIuuuuuuuum,9890,1622,AR,48,31,17,2,Team Random Map
406582,Oonga Boonga,9892,1622,CL,68,44,24,3,Team Random Map
334878,Prodagii,9898,1622,AU,122,66,56,9,Team Random Map
1221240,Prometheus,9904,1622,AU,28,19,9,2,Team Random Map
945601,Ändy,9928,1620,DE,81,38,43,2,Team Random Map
264470,Joako =),9929,1620,CL,21,15,6,1,Team Random Map
206536,ZKWD,9930,1620,FR,378,233,145,5,Team Random Map
834139,Jamal,9932,1620,DE,169,78,91,1,Team Random Map
2231459,miko0,9943,1620,PL,57,33,24,2,Team Random Map
1454846,MocMoc,9951,1620,DE,103,63,40,3,Team Random Map
3533,Mu,9961,1619,BE,225,104,121,11,Team Random Map
277627,Noobao,9983,1618,IE,189,107,82,2,Team Random Map
257300,Anubis_Soldier,9985,1618,MX,45,31,14,0,Team Random Map
568147,Big Chungus,9988,1618,US,295,147,148,10,Team Random Map
2339667,danz,9998,1618,CA,30,21,9,1,Team Random Map
2063614,JACKO,10004,1618,GB,25,18,7,0,Team Random Map
1980338,Tillia,10007,1618,DE,89,47,42,2,Team Random Map
762989,Nico Lyto Gg,10028,1617,CL,134,71,63,8,Team Random Map
2135750,LilTro44,10038,1617,US,70,46,24,0,Team Random Map
335549,arranley,10042,1617,SK,117,69,48,1,Team Random Map
2673312,Nefro,10063,1616,GE,21,12,9,2,Team Random Map
1530929,Rhaxel,10075,1616,FR,35,27,8,0,Team Random Map
330510,Dysnomian,10104,1615,NZ,38,29,9,2,Team Random Map
240176,Bierzantiner,10125,1614,DE,178,86,92,0,Team Random Map
530448,[KoA]BloodShed,10128,1614,AU,34,21,13,1,Team Random Map
493651,朱颜辞镜花辞树,10129,1614,CN,90,55,35,11,Team Random Map
401685,_thezonzolo_,10133,1614,GB,152,84,68,2,Team Random Map
2448695,ByNIN,10135,1614,CL,115,65,50,3,Team Random Map
1989208,Rosdenar,10141,1614,DE,34,22,12,0,Team Random Map
1792275,edo.andreotti,10146,1614,IT,190,103,87,9,Team Random Map
1163761,ICM_DOVAKIIN,10155,1613,GB,27,21,6,3,Team Random Map
273618,vready92,10189,1612,DE,52,34,18,0,Team Random Map
706248,Demetrocles,10220,1611,US,219,109,110,3,Team Random Map
2158296,huawa,10234,1611,AT,44,29,15,4,Team Random Map
1091167,CaesarSaladin,10277,1609,US,256,133,123,6,Team Random Map
884491,Lord of cheese,10280,1609,IN,48,33,15,1,Team Random Map
368911,ZorroZT,10296,1609,DE,213,107,106,6,Team Random Map
1862026,584860439,10338,1608,CN,154,84,70,2,Team Random Map
2602967,yunito000,10366,1607,CL,20,15,5,0,Team Random Map
2329581,mattchang,10367,1607,TW,41,23,18,0,Team Random Map
608607,FangTR,10386,1606,US,100,35,65,2,Team Random Map
148563,Lemonade,10396,1606,NZ,72,43,29,5,Team Random Map
1875305,Blane,10402,1606,FR,189,93,96,2,Team Random Map
1586325,EDL Spitfire,10406,1606,GB,282,138,144,10,Team Random Map
2188040,Shanks,10428,1605,TR,70,41,29,1,Team Random Map
338548,完棄壽司@小子,10433,1605,HK,34,16,18,0,Team Random Map
894839,Feathers McGraw,10449,1604,AU,86,53,33,1,Team Random Map
787853,grzegor2005,10494,1603,GB,229,130,99,5,Team Random Map
669375,jillmji,10524,1602,CN,68,45,23,2,Team Random Map
2547340,_HerTz___,10566,1601,AR,17,13,4,2,Team Random Map
2593834,knightville,10604,1600,GB,39,26,13,1,Team Random Map
2166771,deadboi,10612,1600,BE,132,75,57,3,Team Random Map
2108995,Svarkku,10615,1600,FI,80,39,41,1,Team Random Map
352704,ThePrototype,10616,1600,AU,157,70,87,2,Team Random Map
260822,friends,10641,1599,DE,74,39,35,2,Team Random Map
2571633,Filip,10649,1599,PL,30,23,7,1,Team Random Map
1469609,Carpect,10665,1599,FR,30,23,7,1,Team Random Map
1252863,CowardlyBastard,10671,1599,AU,38,24,14,1,Team Random Map
884170,birdperson,10678,1598,DE,109,65,44,9,Team Random Map
896261,[DD] Flempopo,10708,1597,DK,315,166,149,9,Team Random Map
733091,Eskandir,10710,1597,DE,23,15,8,2,Team Random Map
547689,F G,10715,1597,TR,219,106,113,7,Team Random Map
1710972,TomikuS,10734,1597,CZ,76,50,26,0,Team Random Map
718451,| JNP |,10744,1596,DE,75,44,31,1,Team Random Map
13280,Mamoo1460,10752,1596,NA,191,108,83,4,Team Random Map
924780,Jedi Inting,10777,1595,DE,109,56,53,1,Team Random Map
699329,Ferasu,10781,1595,CO,13,11,2,0,Team Random Map
1848477,Nuba,10797,1595,AR,58,40,18,4,Team Random Map
984704,Boudabras,10813,1594,US,240,121,119,7,Team Random Map
501606,Cello,10819,1594,FR,56,36,20,0,Team Random Map
1765738,red_bod,10838,1594,CA,61,31,30,3,Team Random Map
941979,Lewl,10850,1593,CA,258,149,109,0,Team Random Map
1400212,hiuchung,10880,1593,HK,525,193,332,16,Team Random Map
1304911,watashi,10881,1593,AR,24,14,10,0,Team Random Map
1051156,Elman Quito,10884,1592,ES,43,30,13,7,Team Random Map
382437,BusbegleiterBob,10903,1592,DE,281,136,145,12,Team Random Map
1459805,kalonfest,10913,1592,AT,59,32,27,0,Team Random Map
269591,Chief,10923,1591,DE,39,23,16,1,Team Random Map
1249511,aquinatis,10944,1591,MX,49,31,18,0,Team Random Map
1017075,Trollyan,10950,1590,RU,194,83,111,6,Team Random Map
2723392,Lord_calderon,10962,1590,AR,17,11,6,0,Team Random Map
7392,넌누구니,10974,1590,KR,404,250,154,10,Team Random Map
735058,TheHiggsMoron,10984,1589,DE,104,60,44,2,Team Random Map
227724,Tristi,10993,1589,DE,100,67,33,4,Team Random Map
1916782,spooky zoopro,11000,1589,DE,44,21,23,1,Team Random Map
1683671,MrHabilis,11002,1589,GB,259,118,141,5,Team Random Map
319230,DreamTrawler,11003,1589,US,15,13,2,1,Team Random Map
251010,Gilbert Stays At Home,11011,1588,HK,331,145,186,12,Team Random Map
1005258,Gwiel,11042,1587,DE,12,11,1,0,Team Random Map
793738,AoE_Euer_Juergen,11047,1587,DE,129,73,56,3,Team Random Map
437598,Pieden,11053,1587,DE,156,86,70,3,Team Random Map
2010952,Artu959,11062,1587,IT,11,10,1,0,Team Random Map
1210986,Zender,11070,1587,CA,221,99,122,5,Team Random Map
1019235,Matz,11076,1586,DE,133,78,55,2,Team Random Map
2111950,GrandmasterFunk,11102,1586,AU,82,46,36,2,Team Random Map
254087,Balerion,11122,1585,AT,10,10,0,0,Team Random Map
227368,VforKickAss,11127,1585,DE,38,25,13,0,Team Random Map
1912881,BlahBlah,11134,1585,US,15,7,8,0,Team Random Map
1604452,LNSA,11137,1585,AR,105,57,48,8,Team Random Map
2507545,0010001010,11152,1584,CL,18,14,4,0,Team Random Map
1149247,Feducu,11173,1583,AR,119,55,64,3,Team Random Map
284317,Marcus,11174,1583,GB,80,54,26,1,Team Random Map
1658628,aDr-,11199,1583,FR,158,85,73,5,Team Random Map
2686141,hang9090,11215,1582,HK,12,4,8,0,Team Random Map
2049861,Hellscream,11256,1581,CN,505,235,270,15,Team Random Map
362484,Buchi,11286,1580,AT,36,24,12,0,Team Random Map
1095699,santislash,11303,1579,AR,142,74,68,1,Team Random Map
1090500,Kornflexe,11304,1579,NA,176,101,75,5,Team Random Map
210591,Link,11319,1579,DE,185,96,89,5,Team Random Map
2520445,TheVipa,11330,1579,BR,21,17,4,0,Team Random Map
1638977,Ginebrasz,11342,1579,MX,115,60,55,1,Team Random Map
840293,Camvais,11353,1578,FI,49,32,17,1,Team Random Map
551949,LizenzEnte50,11358,1578,NA,92,57,35,2,Team Random Map
516899,Nigho,11360,1578,RO,172,97,75,4,Team Random Map
473207,Quelfalas,11391,1577,TR,125,59,66,3,Team Random Map
917389,T.BLADE,11413,1576,US,35,26,9,2,Team Random Map
351679,MontyBurns_GP,11435,1576,DE,70,40,30,2,Team Random Map
318687,Zemaitis32,11442,1576,US,175,92,83,7,Team Random Map
1203937,Ontimpa,11447,1576,DE,102,53,49,12,Team Random Map
964948,imugemorihasam,11452,1575,DE,89,41,48,6,Team Random Map
688454,DivideByZero,11454,1575,NL,27,17,10,1,Team Random Map
2500021,joputa locura parce,11464,1575,AR,67,38,29,2,Team Random Map
2030448,Atza,11474,1575,MX,107,46,61,6,Team Random Map
2025336,A,11475,1575,BR,225,89,136,4,Team Random Map
317612,edesa1000,11483,1575,KR,56,38,18,2,Team Random Map
247359,Stavros,11492,1574,GR,71,45,26,0,Team Random Map
2655893,Millsoir,11499,1574,US,17,13,4,1,Team Random Map
2024678,childofbodom1989,11504,1574,US,114,63,51,3,Team Random Map
1216146,TJ,11519,1574,US,132,75,57,2,Team Random Map
2327684,Iplk,11542,1573,AU,14,13,1,0,Team Random Map
774535,zero,11565,1572,FR,174,99,75,2,Team Random Map
770950,hans_im_schluck,11566,1572,DE,13,9,4,0,Team Random Map
2652782,Magnum XL,11574,1572,AT,21,16,5,0,Team Random Map
2509430,-IDE-Simon,11580,1572,DE,87,50,37,2,Team Random Map
2461088,TheSon,11581,1572,VN,160,83,77,0,Team Random Map
844168,Djonaar,11601,1571,FR,42,22,20,3,Team Random Map
2419519,Tikétack,11611,1571,FR,62,42,20,2,Team Random Map
268489,rastadu62,11632,1570,FR,151,85,66,1,Team Random Map
2167122,The Big Bad Wolf,11645,1570,BE,81,39,42,3,Team Random Map
1810972,Baumewok,11652,1570,DE,105,65,40,1,Team Random Map
2676923,cuAto,11668,1569,CO,11,7,4,1,Team Random Map
377045,Dyro,11673,1569,DE,89,54,35,5,Team Random Map
1962988,John O'vinada,11680,1569,CL,24,10,14,0,Team Random Map
1326144,Ethop,11690,1569,CA,34,18,16,0,Team Random Map
703487,Maltin,11699,1568,FR,181,91,90,10,Team Random Map
242999,[WF] LeDude,11701,1568,DE,64,34,30,0,Team Random Map
234520,RickyT1,11733,1567,HK,59,36,23,0,Team Random Map
2352999,N1NJASKILLZZZ,11737,1567,US,68,43,25,0,Team Random Map
2040908,SuperNoodle,11746,1567,CH,54,26,28,0,Team Random Map
2036237,Onlytiger,11747,1567,US,73,50,23,0,Team Random Map
208704,IsoldeBaden,11750,1567,DE,39,27,12,3,Team Random Map
1762799,ninja,11756,1567,HK,87,50,37,3,Team Random Map
1567270,ThingsILack,11759,1567,US,56,38,18,1,Team Random Map
597727,Azur,11801,1565,DE,142,60,82,7,Team Random Map
540993,Joker,11802,1565,DE,17,14,3,0,Team Random Map
1782455,CN_Dauh,11822,1565,CN,44,30,14,1,Team Random Map
655575,Elvarah,11834,1564,AU,120,53,67,1,Team Random Map
1807530,Fadutzu,11849,1564,RO,188,85,103,4,Team Random Map
1203116,mausrr,11858,1564,DE,57,35,22,0,Team Random Map
1051343,mezdap,11863,1563,TR,172,85,87,8,Team Random Map
1364169,LunaTIC,11895,1563,FI,97,53,44,1,Team Random Map
869122,{ST}MQARG,11907,1562,AR,223,81,142,9,Team Random Map
2111730,samsonice,11933,1562,DE,54,35,19,2,Team Random Map
1902539,Lotus,11939,1562,US,99,53,46,3,Team Random Map
398701,Gzwsmnmd,11974,1561,CN,49,29,20,4,Team Random Map
1500548,Bloubou,11998,1561,FR,66,42,24,1,Team Random Map
1773264,JUGO GLATZE MIT BETRÜGER MASCHE,12030,1560,CH,11,7,4,0,Team Random Map
738135,Tonyama,12040,1559,CZ,15,9,6,0,Team Random Map
1293807,F,12074,1559,BR,14,9,5,3,Team Random Map
1559605,Song,12147,1557,CN,21,12,9,0,Team Random Map
1348083,Alkarie,12154,1557,FR,130,63,67,2,Team Random Map
362059,Lord Poephaan,12179,1556,BE,165,96,69,8,Team Random Map
1410675,Beer Gardener,12194,1556,AT,49,24,25,2,Team Random Map
521325,Sabaduqui,12203,1555,AR,178,94,84,8,Team Random Map
431805,Rabbit Senpai,12207,1555,TR,74,46,28,1,Team Random Map
2485377,Terra,12209,1555,AR,56,27,29,0,Team Random Map
1408147,Taktik,12223,1555,BE,30,19,11,0,Team Random Map
734621,melixc77,12232,1554,CL,203,104,99,12,Team Random Map
665204,Voxxeron,12235,1554,NA,238,119,119,21,Team Random Map
2452496,dmalign d great,12246,1554,NL,151,71,80,2,Team Random Map
359093,knukie,12251,1554,DE,112,50,62,5,Team Random Map
523886,GaTTo,12276,1553,BR,460,219,241,15,Team Random Map
1334547,Filip,12304,1553,BE,289,158,131,1,Team Random Map
240210,CapCalamari,12317,1552,AT,108,54,54,5,Team Random Map
2537074,joaco,12329,1552,UY,96,51,45,9,Team Random Map
2402790,Cowboy54,12331,1552,US,15,13,2,0,Team Random Map
1879906,WaffleBasket,12432,1550,NL,24,16,8,0,Team Random Map
1399027,Colem,12444,1550,FR,101,61,40,2,Team Random Map
982325,TCBTheLegend,12452,1549,DE,48,27,21,1,Team Random Map
718485,Rodolink,12453,1549,FR,59,36,23,1,Team Random Map
236336,Lembit Rämedäb,12458,1549,EE,58,33,25,0,Team Random Map
1879875,kaamoss,12474,1549,TR,75,44,31,5,Team Random Map
2083027,tevo011,12515,1548,PY,84,45,39,0,Team Random Map
1563046,HappilyNomadic,12520,1548,GB,65,41,24,1,Team Random Map
1433930,TornnnN,12525,1548,FR,423,221,202,9,Team Random Map
202241,Mama,12531,1547,CA,24,21,3,0,Team Random Map
268226,Unafano,12532,1547,AR,151,77,74,11,Team Random Map
1976439,Almendou,12551,1547,AR,19,12,7,2,Team Random Map
1487542,QuốcThịnh,12556,1547,VN,75,44,31,1,Team Random Map
798470,ifanzin,12563,1546,BR,72,48,24,6,Team Random Map
345654,area51-x,12580,1546,AE,29,21,8,0,Team Random Map
1211723,Sho Ya,12591,1546,CA,33,17,16,2,Team Random Map
624038,Bagpipe,12604,1545,DE,114,66,48,3,Team Random Map
2490016,The Entire Soviet Union,12619,1545,US,16,9,7,0,Team Random Map
1918515,kartoffel,12626,1545,DE,149,71,78,6,Team Random Map
692260,Slim's dog,12646,1544,DK,103,57,46,2,Team Random Map
1672534,t3,12671,1544,GB,38,21,17,0,Team Random Map
1597839,Artem der Schäbige,12674,1544,DE,177,88,89,1,Team Random Map
2322777,Wuchty le Magnifique,12701,1543,FR,22,15,7,0,Team Random Map
2056050,Lord|Bopp,12707,1543,CL,91,55,36,2,Team Random Map
1440212,Gaia,12716,1543,TR,35,19,16,0,Team Random Map
2431321,chwiens,12737,1542,US,16,14,2,0,Team Random Map
1201823,cheetah,12796,1541,DE,74,36,38,0,Team Random Map
1192545,Sergeant [GUIRAL],12797,1541,CA,231,118,113,19,Team Random Map
964500,oscarastatw,12802,1540,TW,38,23,15,5,Team Random Map
1812599,nhljunkie68,12825,1540,NA,316,177,139,26,Team Random Map
1085645,McMaart,12835,1539,DE,231,119,112,17,Team Random Map
244985,t00nafux,12846,1539,US,99,60,39,2,Team Random Map
1739554,goplayfrag,12879,1539,DE,107,53,54,1,Team Random Map
222938,Metalicox,12915,1538,CL,31,22,9,0,Team Random Map
268893,leonardflp78,12937,1537,AU,100,51,49,2,Team Random Map
1962506,Sherwell,12985,1536,MX,77,43,34,6,Team Random Map
1301743,Lazvy,12996,1536,FR,163,83,80,7,Team Random Map
1298037,Stezen9096,12997,1536,NA,360,167,193,5,Team Random Map
362024,Project Exile,13018,1535,DE,103,54,49,2,Team Random Map
1953846,WitcheR,13020,1535,TR,80,45,35,1,Team Random Map
1464083,TheAToast9315,13026,1535,NA,213,102,111,9,Team Random Map
1312769,Da King I.,13027,1535,AT,84,47,37,1,Team Random Map
826992,Zettabyte,13036,1534,CL,41,27,14,2,Team Random Map
814625,TentaGhandi,13037,1534,SE,186,101,85,2,Team Random Map
2576152,Sun Li,13046,1534,DE,32,20,12,0,Team Random Map
1970914,Alliumator,13057,1534,DE,160,62,98,2,Team Random Map
1058874,GoolGoth*[!],13074,1533,GB,19,13,6,0,Team Random Map
2666826,_[eC]_SamueL_,13096,1533,IT,49,24,25,7,Team Random Map
2645219,developersem,13097,1533,TR,21,12,9,2,Team Random Map
2020402,SLicE5647,13104,1533,NA,84,47,37,0,Team Random Map
348556,Veilanof,13106,1533,ES,221,122,99,9,Team Random Map
330448,Emrakul,13112,1533,DE,62,33,29,2,Team Random Map
1603576,BasicLobster853,13114,1533,NA,16,12,4,2,Team Random Map
1349656,Depsi,13118,1533,FR,62,40,22,1,Team Random Map
819423,kuartsi,13126,1532,FI,108,60,48,3,Team Random Map
246185,FrankTheTank,13129,1532,DE,263,146,117,7,Team Random Map
499818,Olly,13136,1532,TR,94,45,49,3,Team Random Map
1842187,/pantsyboy,13155,1532,US,93,47,46,1,Team Random Map
2483390,SCORPYON,13184,1531,RO,67,34,33,2,Team Random Map
2066667,blqck,13195,1531,FR,156,76,80,1,Team Random Map
259840,skinnyplayboy,13210,1530,DE,136,78,58,5,Team Random Map
424044,IncaHootsWithMahouts,13221,1530,GB,93,51,42,3,Team Random Map
1417825,Bojack,13247,1530,DE,76,49,27,2,Team Random Map
967312,Smutsig,13253,1529,SE,143,71,72,2,Team Random Map
1743425,PL0DDYL1FE,13278,1529,NA,95,54,41,0,Team Random Map
1152198,RomanClaw856036,13286,1528,NA,129,72,57,4,Team Random Map
269034,Eddoe,13288,1528,NL,57,37,20,0,Team Random Map
80536,Glandalff,13295,1528,CH,15,13,2,1,Team Random Map
2642833,tomishibachti,13300,1528,BE,21,13,8,1,Team Random Map
316932,Perfect Roe,13322,1528,NZ,37,23,14,2,Team Random Map
274990,Falco,13329,1527,DE,32,23,9,1,Team Random Map
623761,FacundoBernardez89,13332,1527,AR,144,76,68,7,Team Random Map
591146,War_Beast,13333,1527,AU,212,106,106,6,Team Random Map
1542149,[KAY] Xasnoz,13397,1526,AR,59,34,25,3,Team Random Map
1228358,Liopoldo,13402,1526,ES,60,34,26,0,Team Random Map
688886,thibault.gpil,13418,1525,FR,39,23,16,0,Team Random Map
477182,Shadow of Olympus,13425,1525,AR,10,9,1,0,Team Random Map
550578,Invictrus,13465,1524,AT,140,77,63,5,Team Random Map
2181026,gilroy204,13478,1524,GB,25,15,10,0,Team Random Map
2056636,TacheE,13484,1524,MX,23,14,9,0,Team Random Map
278959,namejeff,13501,1523,AU,36,17,19,2,Team Random Map
697614,Crokien,13508,1523,CO,237,107,130,10,Team Random Map
188855,Boengar,13520,1523,AT,140,77,63,1,Team Random Map
1428560,Ravamax,13535,1523,FR,114,63,51,4,Team Random Map
489524,YasuoOP,13561,1522,NL,39,25,14,1,Team Random Map
1751745,Finn,13586,1522,DE,14,9,5,0,Team Random Map
1462465,Stonah,13591,1522,AT,18,9,9,1,Team Random Map
255569,maxmax,13604,1521,TW,181,89,92,5,Team Random Map
2327650,Thomas White,13623,1521,CL,182,91,91,13,Team Random Map
1341617,The real legend,13640,1521,DE,306,169,137,5,Team Random Map
744586,mestariteos,13692,1519,FI,99,52,47,0,Team Random Map
1945362,ShermanBro,13715,1519,AR,94,53,41,1,Team Random Map
1510665,JourneyofaNoob,13723,1519,TR,98,57,41,2,Team Random Map
381282,vyas_23,13756,1518,GB,25,22,3,1,Team Random Map
1820157,alstan,13767,1518,BR,65,33,32,3,Team Random Map
1054725,LordKaigan,13780,1517,FR,117,60,57,2,Team Random Map
46729,EnquiringStone,13782,1517,NA,20,11,9,0,Team Random Map
1966107,nim2,13803,1517,AT,47,22,25,2,Team Random Map
514338,Cal1um2,13840,1516,GB,14,11,3,1,Team Random Map
447085,Juanrrior,13842,1516,CO,25,19,6,2,Team Random Map
2264287,General_Anoosh,13887,1515,IN,23,17,6,2,Team Random Map
338148,Jkob,13896,1515,AU,18,11,7,1,Team Random Map
1065732,Cancer Foundation,13909,1514,DE,124,63,61,6,Team Random Map
979474,Bacdou,13911,1514,FR,38,25,13,4,Team Random Map
771319,[HOBO]Bindlestick,13917,1514,US,233,111,122,3,Team Random Map
549681,BamBamBam,13923,1514,TR,80,40,40,3,Team Random Map
1480911,HotHead,13948,1514,DE,48,30,18,7,Team Random Map
15682,PÖPI,13969,1513,FI,52,26,26,0,Team Random Map
235555,Applecrack,13970,1513,CL,125,63,62,2,Team Random Map
275331,Oso Malayo,14004,1512,CL,126,64,62,3,Team Random Map
985628,frailix,14005,1512,DE,112,54,58,8,Team Random Map
2475737,oguzhan_g,14026,1512,TR,12,9,3,0,Team Random Map
1479588,Jokakutihuti,14046,1512,FI,126,72,54,1,Team Random Map
508796,Emi_Vazquez,14069,1511,AR,126,69,57,2,Team Random Map
397462,Kangaria,14075,1511,US,16,11,5,0,Team Random Map
225359,Shiro,14077,1511,CL,60,33,27,2,Team Random Map
2462300,RaveN,14080,1511,ES,11,9,2,0,Team Random Map
1978680,Sebalmafuerte,14088,1511,AR,68,40,28,0,Team Random Map
925323,Vroomer,14110,1510,CZ,72,39,33,5,Team Random Map
2216254,Gura,14131,1510,CL,45,25,20,2,Team Random Map
322498,[VL] Cherokee,14143,1510,MX,18,8,10,1,Team Random Map
299868,DC,14151,1510,BR,107,63,44,4,Team Random Map
283364,nestor the argonaut,14156,1509,GB,270,143,127,7,Team Random Map
1919390,Kaiser Balduin,14181,1509,DE,141,64,77,11,Team Random Map
255456,Friedl,14203,1508,DE,140,75,65,3,Team Random Map
1001134,{Saint Crùzader} .ƒr,14238,1507,FR,27,16,11,1,Team Random Map
658899,matt_Solo,14243,1507,HK,11,10,1,0,Team Random Map
15809,Lile-Insume,14244,1507,CH,119,62,57,0,Team Random Map
2482662,MilchKoyote7566,14257,1507,NA,45,26,19,1,Team Random Map
2435553,Meerenn,14261,1507,FR,70,38,32,3,Team Random Map
2378787,Allen,14264,1507,TW,38,22,16,0,Team Random Map
1289884,Enlightened Fox,14285,1507,GB,168,77,91,3,Team Random Map
734881,Rene_757,14298,1506,AT,19,15,4,1,Team Random Map
535399,Krylir,14302,1506,PL,115,55,60,9,Team Random Map
2435730,Rodrigo,14311,1506,AR,33,18,15,1,Team Random Map
364709,s316aac,14318,1506,TW,215,101,114,6,Team Random Map
1216828,branflakes1337,14336,1506,NA,139,69,70,7,Team Random Map
761223,frosty6731,14348,1505,US,146,71,75,1,Team Random Map
2628165,Carlos Messina,14358,1505,AR,31,21,10,2,Team Random Map
224461,[Inkas'A] Gatsby,14364,1505,PE,72,42,30,7,Team Random Map
1211615,Ridash,14383,1505,SE,50,32,18,0,Team Random Map
832726,SuperSysel,14393,1504,CZ,58,33,25,0,Team Random Map
372908,Zeek!,14408,1504,IN,52,27,25,3,Team Random Map
2030679,ChApi,14415,1504,AR,86,36,50,12,Team Random Map
513759,rbroggoli,14445,1503,CH,15,9,6,0,Team Random Map
2704261,emp,14448,1503,TR,38,23,15,0,Team Random Map
2549621,jeremygnewton,14453,1503,US,16,11,5,0,Team Random Map
2251573,OkadaSan,14456,1503,BR,54,22,32,5,Team Random Map
1596036,Tantalus,14475,1503,DK,100,48,52,1,Team Random Map
1082286,dejan,14481,1502,SI,191,85,106,2,Team Random Map
2557125,Bloody nine fingers,14497,1502,NL,27,14,13,1,Team Random Map
224987,Pumkin,14498,1502,NO,208,106,102,8,Team Random Map
2005051,Shulian,14508,1502,AR,117,65,52,4,Team Random Map
2392849,coolcats4days,14541,1501,US,62,25,37,1,Team Random Map
1809850,栗悟饭和龟波功,14551,1501,CN,29,20,9,0,Team Random Map
319899,Drumstick47,14557,1501,CA,87,52,35,3,Team Random Map
1493917,IronDragon,14558,1501,DE,120,65,55,2,Team Random Map
236788,holland89,14579,1500,ES,18,14,4,0,Team Random Map
1771467,Balfredo9098,14606,1500,NA,21,15,6,4,Team Random Map
1627080,Tsure_CZ,14608,1500,CZ,230,110,120,5,Team Random Map
717825,Considéré en tant que tel,14629,1499,FR,21,12,9,1,Team Random Map
631067,koopa,14633,1499,US,64,39,25,5,Team Random Map
156262,finalDota2,14637,1499,CN,167,83,84,5,Team Random Map
2446863,DC,14642,1499,CO,60,30,30,1,Team Random Map
2000565,G-ISIS,14652,1499,DE,115,63,52,5,Team Random Map
790494,joshgav,14675,1498,US,61,39,22,1,Team Random Map
1467421,Chapapote,14701,1498,ES,218,111,107,17,Team Random Map
285283,BOBACHICKEN,14705,1497,DE,260,124,136,6,Team Random Map
1825870,Trufelli,14737,1497,BR,50,28,22,2,Team Random Map
268466,At0mflunder,14748,1496,DE,38,20,18,0,Team Random Map
799142,MADOSKA,14750,1496,AR,73,33,40,2,Team Random Map
2235126,Pol1025,14761,1496,NA,13,12,1,0,Team Random Map
2078592,Jinshow,14764,1496,AR,92,49,43,2,Team Random Map
1419329,Pourpel,14777,1496,US,91,45,46,2,Team Random Map
858498,Despir,14786,1495,FR,159,84,75,1,Team Random Map
544921,-----------,14795,1495,PT,35,26,9,1,Team Random Map
527240,SIMBJOSUE,14796,1495,MX,66,38,28,5,Team Random Map
407797,SilverAflame,14802,1495,US,127,63,64,3,Team Random Map
2404296,yvzbaba,14807,1495,NA,87,53,34,1,Team Random Map
2356914,tokyo_PD,14809,1495,SI,123,60,63,4,Team Random Map
2263737,TheSkrill,14812,1495,RO,13,9,4,0,Team Random Map
1183397,SirLancelot,14827,1495,DE,40,23,17,1,Team Random Map
908968,Жin,14833,1494,CH,10,10,0,0,Team Random Map
860293,AOE_Arnaud,14834,1494,FR,52,30,22,0,Team Random Map
488971,DocToR,14845,1494,TR,159,81,78,1,Team Random Map
439207,Baato,14848,1494,SI,48,28,20,0,Team Random Map
393975,fl0gression,14856,1494,DE,372,150,222,25,Team Random Map
1953581,lazaro2201,14871,1494,FR,129,71,58,0,Team Random Map
1747449,matias_barckley,14874,1494,ES,83,41,42,1,Team Random Map
1534447,Natsu,14877,1494,PL,111,63,48,1,Team Random Map
574424,party poison,14894,1493,AR,39,25,14,2,Team Random Map
2653474,Lord Polaris,14898,1493,FI,36,17,19,0,Team Random Map
2060189,Korkhov,14905,1493,FR,168,89,79,0,Team Random Map
1904304,obmar31,14907,1493,TW,18,16,2,0,Team Random Map
1898878,Krazy Kurwa Kid V.2,14908,1493,SE,22,17,5,1,Team Random Map
268970,6 meter kuk,14921,1492,DE,55,35,20,1,Team Random Map
739992,felipeaffc,14928,1492,BR,46,30,16,4,Team Random Map
628541,HuK,14932,1492,US,363,190,173,5,Team Random Map
589014,Ric,14933,1492,NZ,15,13,2,0,Team Random Map
407872,rdndrty52,14939,1492,US,61,32,29,2,Team Random Map
2353047,Raizen,14980,1491,CL,31,18,13,0,Team Random Map
1114186,Dave Jones,15008,1490,DE,163,88,75,11,Team Random Map
688301,Bevoishot,15062,1489,AU,105,55,50,4,Team Random Map
576710,Goethe Erekt,15065,1489,ES,136,72,64,2,Team Random Map
575130,Mikk,15066,1489,DE,84,50,34,3,Team Random Map
456164,GregnakTheBarbarian,15075,1489,US,57,33,24,4,Team Random Map
2426468,BOT Lauta,15084,1489,AR,12,8,4,0,Team Random Map
2212723,Chiabex,15086,1489,US,79,44,35,1,Team Random Map
2157170,sml,15087,1489,US,12,9,3,0,Team Random Map
1944625,Tucho,15094,1489,UY,101,61,40,10,Team Random Map
1599049,DakroyHD,15097,1489,NA,82,39,43,12,Team Random Map
218145,slumlord,15148,1488,CH,175,83,92,2,Team Random Map
1307724,SuWeiSi,15152,1488,US,54,36,18,0,Team Random Map
215780,WoloLord,15154,1488,ES,43,26,17,0,Team Random Map
2490200,DeTaFiLL,15255,1485,TR,45,27,18,1,Team Random Map
2112305,troof,15270,1485,US,78,44,34,3,Team Random Map
2101157,CovidBryant,15271,1485,ES,15,12,3,0,Team Random Map
1154011,Jayhawk,15287,1484,US,23,15,8,1,Team Random Map
736696,Necrosys,15293,1484,FR,132,73,59,4,Team Random Map
2016748,$r. 51|_3|/|(10,15318,1484,AR,10,8,2,1,Team Random Map
1703845,Shibobo22,15327,1484,NA,106,55,51,5,Team Random Map
1678570,a5ter1x,15328,1484,DE,10,8,2,0,Team Random Map
1524436,sithlord,15333,1484,TR,262,133,129,5,Team Random Map
1356947,niour,15338,1484,GR,83,42,41,3,Team Random Map
2138083,JohnnyBraavo,15371,1483,NL,37,21,16,0,Team Random Map
1290904,MarTPoiss,15388,1483,EE,162,79,83,4,Team Random Map
84653,ChampyBogen,15406,1482,IE,21,14,7,1,Team Random Map
524651,King Maikelu II,15407,1482,BE,85,39,46,0,Team Random Map
453952,Pistolenhenry,15410,1482,CH,167,83,84,7,Team Random Map
2504250,Showbizz V3sk,15518,1480,BE,57,36,21,0,Team Random Map
2392105,Montelo29,15523,1480,MX,29,15,14,0,Team Random Map
1263159,Bertie Wodehouse,15551,1480,AU,84,41,43,4,Team Random Map
286821,Daniel,15553,1479,DE,167,80,87,4,Team Random Map
758066,Outlawuser3,15561,1479,SI,43,29,14,0,Team Random Map
2470723,✪ Loading… ████] 99%,15573,1479,RU,118,56,62,5,Team Random Map
2374475,FallenAngel,15574,1479,US,140,64,76,3,Team Random Map
2239832,Kiwok,15578,1479,AR,13,8,5,0,Team Random Map
1842872,AndiValent,15587,1479,DE,16,9,7,1,Team Random Map
219333,SAM.SEP10L,15591,1479,CA,147,72,75,3,Team Random Map
1678065,Keesiu,15592,1479,DE,49,26,23,2,Team Random Map
973412,IvarI,15600,1478,US,95,52,43,2,Team Random Map
877730,antonienberthe,15602,1478,FR,152,77,75,2,Team Random Map
150211,Tauroxx23,15614,1478,NA,182,79,103,12,Team Random Map
1806819,MC_Terminator,15682,1477,CA,1090,490,600,21,Team Random Map
1781378,rapscalyin,15683,1477,US,20,15,5,0,Team Random Map
298849,WeaselAccordion,15696,1477,US,161,88,73,1,Team Random Map
513697,Strawman,15708,1476,GB,31,18,13,2,Team Random Map
1981211,PsyQor,15721,1476,AU,17,15,2,0,Team Random Map
208328,Lupor9675,15730,1476,NA,74,41,33,0,Team Random Map
258687,Black_Adder,15746,1475,DE,138,66,72,6,Team Random Map
2102082,KULAga,15765,1475,RU,19,15,4,0,Team Random Map
309300,synox,15783,1475,CN,64,35,29,1,Team Random Map
1144573,jcmoney,15789,1474,US,79,37,42,3,Team Random Map
2208527,Sorry i'm not sorry,15816,1474,FR,128,68,60,1,Team Random Map
374571,Ivan Ivanovich Ivanovsky,15862,1473,SE,194,102,92,3,Team Random Map
341187,theworriestkill,15876,1473,DE,14,9,5,0,Team Random Map
969048,Bobby Droptables,15887,1472,PT,17,12,5,0,Team Random Map
1287546,Jewst,15927,1472,US,48,32,16,0,Team Random Map
988417,sungyy,15932,1471,US,69,34,35,0,Team Random Map
793244,yonathan,15936,1471,DE,195,103,92,2,Team Random Map
239649,Rã,15944,1471,TR,86,43,43,2,Team Random Map
2137228,BlackWolf,15961,1471,FR,98,50,48,0,Team Random Map
551029,Ryan Lunzen,15991,1470,DE,44,29,15,0,Team Random Map
209316,Szyber,15996,1470,PL,11,10,1,0,Team Random Map
2096438,nuke,16009,1470,IN,71,31,40,5,Team Random Map
303407,o3infidelo3,16026,1470,US,128,66,62,1,Team Random Map
835394,Wololo,16043,1469,US,191,90,101,4,Team Random Map
613047,God Mode,16048,1469,US,115,58,57,2,Team Random Map
489394,Maicel,16052,1469,CH,83,43,40,3,Team Random Map
1683336,Nobodyx22,16077,1469,DE,31,20,11,0,Team Random Map
1533469,BlissfulBench7,16081,1469,NA,32,22,10,0,Team Random Map
269193,Jonny Quest,16092,1468,US,53,29,24,2,Team Random Map
905409,mikehernandezgiraldo,16094,1468,CO,14,11,3,1,Team Random Map
841799,Elessar,16098,1468,FR,264,130,134,8,Team Random Map
4155,Yoshizz,16112,1468,FR,205,100,105,22,Team Random Map
1949449,Provencal le Gaulois,16129,1468,FR,52,23,29,0,Team Random Map
1943353,fooolik,16130,1468,FR,35,20,15,3,Team Random Map
1875166,Batpapou,16133,1468,FR,13,12,1,0,Team Random Map
915284,Original AI,16150,1467,GB,203,103,100,12,Team Random Map
395245,Guillote,16166,1467,AR,11,9,2,0,Team Random Map
1535067,Strider,16187,1467,NL,123,46,77,3,Team Random Map
1437310,konstantin,16190,1467,DK,81,45,36,0,Team Random Map
799448,Jose de Urquiza,16205,1466,AR,83,46,37,5,Team Random Map
2735496,jant_,16221,1466,FI,27,17,10,1,Team Random Map
2596756,SpiDeY_aToR,16222,1466,ES,27,21,6,3,Team Random Map
2089013,sunlight07,16230,1466,CN,93,42,51,0,Team Random Map
886461,J4n3K,16255,1465,DE,19,15,4,1,Team Random Map
2574968,= =a,16272,1465,AR,27,19,8,2,Team Random Map
572227,Yuri-tarded,16314,1464,DE,59,38,21,1,Team Random Map
235545,Chancelier Palpoutine,16315,1464,FR,227,101,126,6,Team Random Map
1736148,xXxAlessioxXx,16328,1464,NA,193,97,96,1,Team Random Map
1635427,Joonfour,16329,1464,FI,86,41,45,5,Team Random Map
1954721,jungleism.monkey,16374,1463,DE,63,38,25,0,Team Random Map
1825098,MENTZ,16376,1463,BR,131,59,72,1,Team Random Map
1387188,warus974,16384,1463,AU,100,49,51,12,Team Random Map
269421,Applemunch,16399,1462,GB,143,70,73,1,Team Random Map
18139,Jotschi,16407,1462,AT,37,24,13,1,Team Random Map
422549,Fr3aKZ,16412,1462,NO,77,44,33,1,Team Random Map
2698813,yuhu,16415,1462,DE,28,18,10,0,Team Random Map
1682348,Snaked,16442,1462,FR,14,12,2,0,Team Random Map
1960004,Dgorcia,16486,1461,MX,54,36,18,5,Team Random Map
2654906,现在不耍帅,16518,1460,CN,58,34,24,2,Team Random Map
387323,Mannferd,16522,1460,DE,307,155,152,12,Team Random Map
2183562,Ing Electrico,16526,1460,CL,141,80,61,9,Team Random Map
1986910,Sacredsilence,16531,1460,TR,148,73,75,7,Team Random Map
858703,Erilium,16554,1459,TR,65,40,25,0,Team Random Map
2472683,kirby_13,16618,1458,FR,18,13,5,1,Team Random Map
305280,BigO,16642,1458,US,193,96,97,13,Team Random Map
574957,The King in the North,16660,1457,AT,113,51,62,3,Team Random Map
1873601,Milian,16689,1457,DE,40,27,13,0,Team Random Map
249544,York Le Bourrin,16716,1456,FR,138,73,65,10,Team Random Map
1838013,Gusano1186,16743,1456,NA,432,203,229,19,Team Random Map
1450147,ZondaR,16754,1456,US,29,22,7,1,Team Random Map
793793,Bobskii,16775,1455,GB,47,29,18,1,Team Random Map
421385,Raynorshine,16789,1455,AU,130,72,58,3,Team Random Map
2129228,123abcd321,16799,1455,DE,12,10,2,0,Team Random Map
1844135,Cerise IV,16809,1455,NA,370,173,197,14,Team Random Map
1444832,[TPC]Hit the Luke,16815,1455,DE,19,14,5,0,Team Random Map
1151161,JaegerMan,16817,1455,US,24,16,8,2,Team Random Map
1067071,lumpyyy,16826,1454,DE,42,26,16,0,Team Random Map
398486,Morris,16846,1454,DE,43,28,15,4,Team Random Map
2582012,william.lepine,16910,1453,CA,10,10,0,0,Team Random Map
2545338,Bann0wned,16912,1453,IT,108,59,49,2,Team Random Map
369836,Geojak,16916,1453,DE,27,19,8,0,Team Random Map
2045871,Genseric,16920,1453,US,86,33,53,1,Team Random Map
2171965,rezwone,16921,1453,US,16,6,10,1,Team Random Map
364167,Fury,16983,1452,AR,28,20,8,0,Team Random Map
2049114,JP,16987,1452,DE,51,31,20,2,Team Random Map
1492125,XitT,16998,1452,VN,505,209,296,35,Team Random Map
217378,Coal_and_Timber,17000,1452,CH,66,34,32,0,Team Random Map
1407140,2762419051,17003,1452,CN,79,47,32,5,Team Random Map
1288929,nukehat,17008,1452,US,31,20,11,0,Team Random Map
2025974,pedroacostaz11,17044,1451,PE,83,41,42,1,Team Random Map
30775,El Bromas,17055,1451,AR,72,39,33,2,Team Random Map
1424831,prayr,17057,1451,UY,90,44,46,8,Team Random Map
274309,Trench Dog,17115,1449,CA,64,33,31,1,Team Random Map
897628,Kementaris,17118,1449,FR,115,58,57,11,Team Random Map
398279,Visage main,17138,1449,CA,27,21,6,1,Team Random Map
2345950,legomanyak,17141,1449,TR,112,56,56,5,Team Random Map
1784304,Argoon,17159,1449,FI,100,55,45,2,Team Random Map
557790,cab1enzo,17183,1448,AR,225,115,110,5,Team Random Map
1916969,likeboof,17207,1448,FR,103,55,48,0,Team Random Map
115170,Garc99,17218,1448,US,269,137,132,30,Team Random Map
691855,Ramelouille,17238,1447,BE,224,136,88,5,Team Random Map
436949,volkow,17245,1447,FR,133,62,71,8,Team Random Map
1365200,Sugarplum,17273,1447,GB,208,105,103,6,Team Random Map
249172,c l a r r y,17291,1446,DE,187,98,89,3,Team Random Map
2695887,obey,17305,1446,DE,13,9,4,0,Team Random Map
1531314,^^6-=MajorEjaculate=-,17323,1446,CH,72,42,30,1,Team Random Map
1084661,MZ Wang,17405,1444,US,84,45,39,3,Team Random Map
955437,Jerry Lee,17407,1444,CZ,35,24,11,1,Team Random Map
954365,torgengo,17408,1444,DE,285,133,152,24,Team Random Map
782643,Polliainen,17413,1444,FI,67,42,25,1,Team Random Map
644257,_LorDaniel_,17414,1444,HU,93,49,44,3,Team Random Map
581759,DasLetzte,17417,1444,DE,120,68,52,21,Team Random Map
2253922,Fuzuli,17442,1444,TR,266,126,140,3,Team Random Map
1036384,Saladin45,17466,1443,TN,27,15,12,1,Team Random Map
2471688,G0ldenFir3,17481,1443,DE,32,19,13,1,Team Random Map
2171756,Harry Wragg,17491,1443,GB,70,41,29,0,Team Random Map
2127029,Devil.QuangBinh,17492,1443,VN,144,75,69,5,Team Random Map
1951454,EJ,17496,1443,TW,102,50,52,1,Team Random Map
1812087,selordsimo,17501,1443,DE,47,28,19,1,Team Random Map
1434375,JoN,17511,1443,FR,13,12,1,1,Team Random Map
2414534,Æro,17533,1442,DE,18,13,5,0,Team Random Map
1785197,MaxiRiver ;),17543,1442,AR,89,39,50,4,Team Random Map
573954,come1on,17570,1441,DE,76,40,36,0,Team Random Map
554928,horst691,17572,1441,DE,152,78,74,1,Team Random Map
2562188,Letz go,17581,1441,NL,29,19,10,1,Team Random Map
2267898,esanders319,17589,1441,US,16,8,8,2,Team Random Map
923899,Lasthitmagic,17616,1440,IN,62,34,28,0,Team Random Map
896612,MurphQuake,17617,1440,GB,381,180,201,19,Team Random Map
511854,nanodan47,17626,1440,CO,154,73,81,8,Team Random Map
2665093,Admete,17630,1440,US,55,24,31,2,Team Random Map
1828420,Sapinbatou27,17651,1440,NA,234,99,135,3,Team Random Map
1717062,Avesonn,17654,1440,NA,80,45,35,5,Team Random Map
1691357,kldp9432,17655,1440,TW,29,20,9,4,Team Random Map
288483,Tendo,17663,1440,AR,22,10,12,0,Team Random Map
284514,Boom Boom Room,17664,1439,GB,15,12,3,0,Team Random Map
1005646,zh.sledge,17665,1439,CA,19,12,7,0,Team Random Map
1192725,Heos,17771,1438,FR,198,101,97,6,Team Random Map
237507,PapaJohn,17788,1437,GR,524,254,270,4,Team Random Map
445560,Bastianvdkerkhoff,17792,1437,NL,49,24,25,1,Team Random Map
309538,Ashla,17820,1437,US,93,49,44,1,Team Random Map
160650,Arathorn II,17856,1436,AR,54,19,35,0,Team Random Map
1881874,El Libertador,17877,1436,AR,47,29,18,0,Team Random Map
1404736,baccdafucup,17890,1436,DE,17,7,10,0,Team Random Map
1228324,SnakeByte,17894,1436,IL,59,34,25,9,Team Random Map
254475,OmegaRyZ,17907,1435,FR,92,48,44,3,Team Random Map
388223,cavidal1,17921,1435,CL,27,15,12,0,Team Random Map
2103808,Critizie,17936,1435,DE,104,50,54,3,Team Random Map
1329635,Grgo,17952,1435,SK,23,13,10,0,Team Random Map
945191,Dahes,17959,1434,ES,78,39,39,2,Team Random Map
267180,o3li*,17961,1434,DE,74,43,31,2,Team Random Map
597130,NateZMate,17965,1434,FR,164,85,79,8,Team Random Map
2255611,Kenguan,17985,1434,BE,211,93,118,1,Team Random Map
2155619,RuMoe,17990,1434,DE,41,22,19,0,Team Random Map
26544,kol9000,18007,1434,DE,274,135,139,12,Team Random Map
1617039,RemBem,18008,1434,NL,16,12,4,1,Team Random Map
268807,raphael.foscarini,18021,1433,BR,216,108,108,6,Team Random Map
889371,JHLKing,18022,1433,DE,98,53,45,7,Team Random Map
728455,mshep23,18027,1433,US,16,11,5,0,Team Random Map
700616,Noka  \(>///<)/,18029,1433,DE,119,63,56,1,Team Random Map
304001,Sunday,18070,1433,MX,36,22,14,1,Team Random Map
431020,mingweng,18096,1432,ES,37,20,17,0,Team Random Map
2206324,Cirdan,18110,1432,AR,11,8,3,1,Team Random Map
1678267,Heinbert,18126,1432,DE,93,51,42,0,Team Random Map
404136,LAminator,18149,1431,CZ,42,25,17,0,Team Random Map
2621276,Trajan,18150,1431,US,86,52,34,1,Team Random Map
2007010,ElCulSale,18164,1431,FR,115,46,69,14,Team Random Map
1023151,Dzepetto5,18185,1430,GB,50,29,21,3,Team Random Map
171951,Bielson,18201,1430,ES,387,162,225,47,Team Random Map
405297,Roland Ferrier,18207,1430,US,13,11,2,0,Team Random Map
2463182,rspectmyauthoritah,18210,1430,US,10,9,1,0,Team Random Map
90721,le9_7,18211,1430,DE,20,16,4,1,Team Random Map
2189887,筋肉肥仔,18215,1430,HK,10,8,2,0,Team Random Map
213949,6 TC Boom,18252,1429,GB,24,18,6,1,Team Random Map
2688470,OptimalPillow,18265,1429,US,22,13,9,1,Team Random Map
757410,Kjell Kriminell,18305,1428,SE,129,75,54,2,Team Random Map
1927435,sapa578,18340,1428,JP,64,38,26,1,Team Random Map
654290,Rampager,18370,1427,AU,325,152,173,23,Team Random Map
2547071,_Cactus_,18382,1427,BR,45,30,15,2,Team Random Map
220309,Juu Loose,18402,1427,CH,136,71,65,1,Team Random Map
1775168,JST,18405,1427,GB,10,9,1,0,Team Random Map
1184908,yanyuxin2,18415,1427,CN,23,15,8,0,Team Random Map
1008001,Rocar,18419,1426,ES,160,82,78,0,Team Random Map
406237,gilgamesh,18440,1426,US,94,46,48,0,Team Random Map
2598794,RPM,18443,1426,MX,80,43,37,11,Team Random Map
2348611,xuk0,18448,1426,ES,39,23,16,1,Team Random Map
2250670,Parthumax,18452,1426,AR,14,10,4,3,Team Random Map
2120914,sebamarcel,18461,1426,CL,10,7,3,3,Team Random Map
1959274,Deeet_L2,18466,1426,DE,14,9,5,2,Team Random Map
270841,mancera16,18494,1425,CO,56,34,22,0,Team Random Map
924389,Wausz,18496,1425,NL,67,31,36,2,Team Random Map
857098,TiJu,18500,1425,DE,23,17,6,4,Team Random Map
2505390,konredus,18514,1425,AR,55,31,24,1,Team Random Map
2273081,068,18520,1425,US,54,30,24,0,Team Random Map
1866117,Shull Sopapero,18532,1425,AR,10,7,3,0,Team Random Map
521498,tfair7850,18559,1424,US,146,74,72,11,Team Random Map
372710,Aurelius Le Grand,18569,1424,FR,158,73,85,0,Team Random Map
2171383,AT-AK,18572,1424,DE,88,43,45,2,Team Random Map
222736,MortelentaBR,18573,1424,BR,23,14,9,3,Team Random Map
1689106,Koltira,18583,1424,CZ,293,137,156,26,Team Random Map
1586085,必要的沉默,18586,1424,HK,502,192,310,20,Team Random Map
1013995,Babifort,18599,1423,FR,382,151,231,16,Team Random Map
2324026,Coops90,18631,1423,GB,58,35,23,0,Team Random Map
2073007,sHIRO,18639,1423,AR,54,36,18,3,Team Random Map
307688,[IKON] GrandChamp BTW,18651,1423,US,118,53,65,3,Team Random Map
1035336,trebuchet,18659,1422,IN,45,23,22,6,Team Random Map
2439082,Arbuz Budesh,18673,1422,UA,42,25,17,1,Team Random Map
2156614,heyjoh,18679,1422,DE,43,23,20,1,Team Random Map
2128393,P♠LTERSH♠T,18680,1422,LU,54,35,19,1,Team Random Map
1802285,erwan.duv34,18691,1422,FR,31,15,16,3,Team Random Map
330259,DerBonus,18692,1422,DE,94,55,39,1,Team Random Map
1068976,Freekill,18700,1422,DE,115,65,50,1,Team Random Map
323254,Zaid Khan,18736,1421,US,45,28,17,9,Team Random Map
1417397,SlothKing,18745,1421,IT,58,37,21,8,Team Random Map
924441,PK,18761,1420,BR,12,10,2,1,Team Random Map
1489216,T,18803,1420,TW,12,8,4,0,Team Random Map
1059555,khoran86,18814,1419,FR,174,89,85,2,Team Random Map
1025934,AwawaMonster,18816,1419,CL,24,15,9,0,Team Random Map
788365,uberdope,18822,1419,CA,36,15,21,3,Team Random Map
247251,Motan,18826,1419,GB,103,55,48,4,Team Random Map
473378,Kaltenburg,18832,1419,DE,82,46,36,1,Team Random Map
2255259,Infernal,18853,1419,GB,73,46,27,0,Team Random Map
1933871,TheBruTus,18866,1419,AR,30,15,15,0,Team Random Map
1834082,Fiskmåsen,18871,1419,SE,68,38,30,2,Team Random Map
1788514,TopDrilla,18873,1419,GB,102,47,55,4,Team Random Map
682331,Big Bear,18896,1418,AR,174,84,90,2,Team Random Map
1414144,ClearCoyote,18942,1418,DE,112,64,48,4,Team Random Map
1043588,harrisdavi4,18952,1417,NZ,12,10,2,0,Team Random Map
1011098,25982615,18953,1417,CN,156,76,80,19,Team Random Map
860624,TERRORIST PEPE,18957,1417,IT,195,103,92,5,Team Random Map
2584876,le_chick,18970,1417,IN,21,13,8,3,Team Random Map
383193,T O I,18975,1417,DE,82,50,32,9,Team Random Map
2109184,pippepk,18980,1417,AR,13,10,3,0,Team Random Map
2040390,DuckZ.in,18983,1417,BR,88,45,43,3,Team Random Map
273169,SindonistiS,19016,1416,GR,312,129,183,10,Team Random Map
485462,Peku,19032,1416,FI,68,32,36,0,Team Random Map
2493465,FARA,19037,1416,TR,40,17,23,3,Team Random Map
2251715,sampsadios,19044,1416,FI,60,36,24,0,Team Random Map
1622346,Anid.,19062,1416,DE,222,105,117,18,Team Random Map
906762,The_enslaver,19142,1414,AR,92,45,47,2,Team Random Map
2655608,Basse,19160,1414,DE,45,28,17,0,Team Random Map
2526098,xpiAx,19164,1414,TR,167,77,90,11,Team Random Map
2289613,Llambitos Hope,19172,1414,AR,34,19,15,0,Team Random Map
2141722,white rabbit,19181,1414,TR,342,164,178,2,Team Random Map
1748770,GentlemanPyro,19189,1414,CA,44,25,19,2,Team Random Map
297963,Zook,19204,1414,US,10,8,2,0,Team Random Map
1141290,Only MIRAGE// WALL,19209,1413,AR,15,12,3,1,Team Random Map
995576,Mike Jackson,19216,1413,AT,13,12,1,1,Team Random Map
250509,JJ_Ronda,19223,1413,US,64,40,24,4,Team Random Map
2633608,JeyAy,19238,1413,DE,10,6,4,2,Team Random Map
2127687,trannguyenqb,19253,1413,VN,21,12,9,0,Team Random Map
2012548,JRR,19257,1413,AR,92,49,43,0,Team Random Map
1950648,Tea-Man,19259,1413,VN,131,63,68,6,Team Random Map
1536233,Marty,19270,1413,CZ,66,35,31,2,Team Random Map
1523379,starzrc,19271,1413,US,104,50,54,0,Team Random Map
2360919,AOEgod1995,19310,1412,GB,38,21,17,1,Team Random Map
1336226,Tbis,19335,1412,FR,81,48,33,2,Team Random Map
280967,Tshyk [tʃaɪk],19340,1411,DE,18,12,6,0,Team Random Map
224251,RenanMS,19374,1411,CA,299,137,162,12,Team Random Map
1840674,Adiosomg,19390,1411,NA,130,65,65,1,Team Random Map
1779652,jeffisabelle,19394,1411,TR,80,42,38,0,Team Random Map
217307,TJay,19403,1411,DE,128,65,63,6,Team Random Map
1283502,Robert Strong,19405,1411,DE,38,22,16,0,Team Random Map
844845,Rocka 1,19422,1410,MX,62,35,27,3,Team Random Map
1784863,OO KING,19455,1410,GR,74,39,35,2,Team Random Map
318808,CamRoth,19459,1410,US,52,33,19,1,Team Random Map
1516972,Impuseful,19466,1410,RU,168,75,93,4,Team Random Map
304795,Dean Sean Bean,19467,1410,AU,66,36,30,2,Team Random Map
584252,Legendario,19488,1409,BR,258,111,147,12,Team Random Map
2477619,Chuck Norris,19502,1409,RO,40,29,11,1,Team Random Map
1283528,kenmetal,19541,1409,FR,157,72,85,1,Team Random Map
2522474,Häuptling Quack Quack,19573,1408,DE,56,29,27,1,Team Random Map
2188887,lil papa,19585,1408,US,82,42,40,3,Team Random Map
196206,Rheii,19623,1407,FR,41,16,25,1,Team Random Map
422856,holymackerel,19627,1407,GB,60,36,24,0,Team Random Map
386701,Schlagmett,19637,1407,DE,267,132,135,4,Team Random Map
101499,Squøx,19642,1407,DE,19,14,5,0,Team Random Map
958543,Kay777,19671,1406,DE,53,25,28,5,Team Random Map
710818,Legumez,19675,1406,US,10,8,2,0,Team Random Map
413444,kaepora_gaebora,19688,1406,AU,59,34,25,3,Team Random Map
2609286,Shafi,19694,1406,DE,13,7,6,0,Team Random Map
2397629,Julio The Sparrow,19697,1406,GB,68,29,39,5,Team Random Map
2290368,Hühnchen ist nicht vegan?,19703,1406,DE,24,13,11,1,Team Random Map
1737675,side0oeffect,19716,1406,IN,27,18,9,0,Team Random Map
1410971,JEUNE RENOIS SAUVAGE,19720,1406,BE,172,92,80,18,Team Random Map
1884505,Martini,19770,1405,PL,55,29,26,2,Team Random Map
1528769,GaNNiCuS,19779,1405,TR,309,143,166,7,Team Random Map
216358,Amochen,19786,1405,DE,44,25,19,3,Team Random Map
273840,Ganicus92,19792,1404,ES,142,78,64,9,Team Random Map
2063375,LaLuneXIII,19823,1404,FR,66,35,31,0,Team Random Map
2014613,LRI-ItalicFalic,19826,1404,AR,23,11,12,1,Team Random Map
987037,Tomee,19848,1403,AR,58,31,27,4,Team Random Map
910803,Meetjeslander,19852,1403,BE,113,63,50,1,Team Random Map
2500931,SABOTAJ,19866,1403,TR,16,12,4,4,Team Random Map
366793,Alésiæ,19873,1403,FR,105,52,53,0,Team Random Map
2269966,Athanel,19875,1403,CA,18,13,5,1,Team Random Map
54721,RAYONX,19895,1403,FR,33,13,20,1,Team Random Map
2372084,Stebz13,19937,1402,US,30,18,12,0,Team Random Map
891069,but jit is alone,19978,1401,TR,80,44,36,2,Team Random Map
262840,Noobmaster69,19980,1401,DE,84,48,36,2,Team Random Map
365245,Rain McVarelk,20003,1401,FR,25,16,9,1,Team Random Map
2171921,Schmuddlomi,20005,1401,DE,132,71,61,9,Team Random Map
2131886,Theredcore,20009,1401,US,32,23,9,0,Team Random Map
1835087,Azwei,20021,1401,FR,179,90,89,0,Team Random Map
1727013,spritola,20024,1401,NO,88,42,46,9,Team Random Map
1662012,Real Tom,20026,1401,US,144,76,68,1,Team Random Map
892474,Ewoud,20042,1400,NL,13,9,4,0,Team Random Map
251654,QiPepXi,20044,1400,CL,16,10,6,0,Team Random Map
2340929,Deft,20061,1400,MX,36,23,13,3,Team Random Map
1798396,Gröstl,20074,1400,AT,48,27,21,1,Team Random Map
536967,NoMad,20102,1399,BG,75,40,35,1,Team Random Map
469942,Producer,20105,1399,US,30,18,12,0,Team Random Map
2551620,Siberian Khatru,20113,1399,CO,11,9,2,0,Team Random Map
2458965,Yokers,20116,1399,ES,54,33,21,1,Team Random Map
1726685,{GTD} Charmeur18,20144,1399,FR,60,29,31,5,Team Random Map
642067,Richard..?,20166,1398,DE,23,14,9,1,Team Random Map
474731,NotUseful,20178,1398,US,22,15,7,0,Team Random Map
2317692,Signature,20188,1398,IN,48,26,22,0,Team Random Map
2307257,Freshman2025,20189,1398,NA,15,10,5,0,Team Random Map
2098851,Ing. Alucard,20195,1398,SK,138,67,71,0,Team Random Map
225494,SpekBo,20235,1397,CZ,105,53,52,1,Team Random Map
2271197,conkër,20240,1397,CL,14,6,8,0,Team Random Map
2075686,tiddies,20244,1397,AU,109,58,51,5,Team Random Map
2064000,Immuney,20245,1397,IT,66,34,32,2,Team Random Map
2048280,Puntapie,20246,1397,ES,112,55,57,1,Team Random Map
1740276,LowB,20256,1397,HK,55,27,28,3,Team Random Map
1612937,Ansgar,20259,1397,DE,157,64,93,8,Team Random Map
920044,Nilerua,20280,1396,FR,191,92,99,4,Team Random Map
646397,✪LyMpFrEy✪,20290,1396,DE,12,8,4,1,Team Random Map
622639,LordLuke13,20291,1396,BR,406,182,224,25,Team Random Map
2011849,Titein! =D,20319,1396,AR,22,13,9,1,Team Random Map
1679917,StarMikego,20333,1396,CO,161,79,82,19,Team Random Map
1508264,♥ Augusti,20336,1396,TR,87,45,42,7,Team Random Map
1200135,Valorun,20345,1396,FR,33,21,12,1,Team Random Map
1077418,agustinlopezz95,20349,1395,AR,40,25,15,1,Team Random Map
863791,FerV,20356,1395,ES,61,35,26,2,Team Random Map
498570,GRAND AZTEC FORTIFICATIONS,20372,1395,RU,152,72,80,7,Team Random Map
229381,Sven Forkbeard,20375,1395,SE,114,58,56,4,Team Random Map
368368,webber-,20387,1395,AR,14,10,4,0,Team Random Map
913899,KanyarGG,20420,1394,TR,140,69,71,9,Team Random Map
93564,I'm Sexy and I Know It,20439,1394,VN,154,67,87,13,Team Random Map
384640,xX69DildoSwaggins420Xx,20440,1394,AT,236,115,121,9,Team Random Map
343307,Korner,20456,1394,BR,192,81,111,12,Team Random Map
1820853,Jaimeph,20460,1394,CA,197,99,98,10,Team Random Map
1678910,PanikMuenze284,20461,1394,NA,23,16,7,0,Team Random Map
962806,Fujichan,20479,1393,FR,215,103,112,3,Team Random Map
2433516,wang_noob,20495,1393,GB,11,9,2,0,Team Random Map
2015508,diegop06,20511,1393,AR,60,24,36,6,Team Random Map
346895,Tamil_Nadu,20516,1393,CN,180,97,83,12,Team Random Map
1473887,✰-Le-Petit-Suisse-✰,20536,1393,FR,80,36,44,3,Team Random Map
1378045,Earl G of AOE,20540,1393,AU,49,25,24,1,Team Random Map
213097,uft.jack,20554,1392,IQ,64,30,34,16,Team Random Map
372385,mateo,20583,1392,PL,51,28,23,0,Team Random Map
2036810,jmerice93,20590,1392,ES,81,47,34,2,Team Random Map
1402393,j1805,20606,1392,FR,51,27,24,4,Team Random Map
1282709,syxlox☁,20609,1392,DE,62,30,32,0,Team Random Map
2435090,oulouvator,20641,1391,FR,58,29,29,1,Team Random Map
220940,CBTimaun,20660,1391,BR,333,159,174,10,Team Random Map
1147772,Oxidars,20683,1390,FR,21,17,4,0,Team Random Map
258220,derri,20693,1390,ES,151,70,81,10,Team Random Map
527456,Juniorr,20700,1390,AR,37,22,15,5,Team Random Map
92419,[GI MONO] YOPH,20705,1390,MX,167,71,96,5,Team Random Map
2051572,RuL,20721,1390,ES,179,83,96,3,Team Random Map
330392,riento,20726,1390,FR,82,47,35,3,Team Random Map
547102,tzengo,20753,1389,DE,45,31,14,0,Team Random Map
233419,Master,20761,1389,TR,17,14,3,2,Team Random Map
2480712,lele,20766,1389,TR,156,75,81,0,Team Random Map
2064286,veganemayonnaise,20780,1389,DE,56,31,25,4,Team Random Map
1954837,PA,20784,1389,FR,95,54,41,7,Team Random Map
1826951,OldPineapple,20787,1389,US,46,18,28,0,Team Random Map
1283214,lefabbe,20799,1389,BE,61,36,25,1,Team Random Map
648330,Lord Frosch,20825,1388,DE,267,123,144,8,Team Random Map
235242,Szymski,20829,1388,PL,13,10,3,0,Team Random Map
2290120,v01d,20849,1388,US,24,16,8,0,Team Random Map
2111898,Tyrfox COL,20914,1387,NA,59,27,32,7,Team Random Map
1892196,JoeSham,20922,1387,CZ,80,46,34,1,Team Random Map
1604154,535742814,20933,1387,CN,256,112,144,29,Team Random Map
404851,Foolish Hunter,20962,1386,US,121,55,66,6,Team Random Map
2047228,Kap_tainn,20987,1386,FR,91,40,51,5,Team Random Map
2697803,Vader_Prime,21028,1385,IN,24,13,11,3,Team Random Map
2687199,APPiccio,21029,1385,IT,13,11,2,0,Team Random Map
2534112,Fran,21034,1385,AR,99,54,45,1,Team Random Map
2509955,Crimat,21035,1385,CA,101,55,46,0,Team Random Map
2192356,KJEMPEBRA,21042,1385,NO,123,70,53,0,Team Random Map
1752222,[Alpha] Capone,21059,1385,DE,185,92,93,13,Team Random Map
1683369,Luki,21060,1385,AT,147,71,76,5,Team Random Map
1264409,King Arthur,21072,1385,AR,127,63,64,0,Team Random Map
460601,Fiesling,21090,1384,DE,21,7,14,0,Team Random Map
2554870,Toftomatic,21098,1384,GB,13,8,5,0,Team Random Map
384931,[TNW] Jminsanity,21104,1384,US,17,11,6,1,Team Random Map
211284,Snweos,21161,1383,AU,13,9,4,0,Team Random Map
544303,"The Forgotten Boar Rising:,'(",21170,1383,DE,95,43,52,3,Team Random Map
469666,BarefootCoast66,21174,1383,NA,86,49,37,1,Team Random Map
431835,ERRICOS4,21175,1383,AU,235,111,124,14,Team Random Map
825901,Dervish,21237,1382,DE,35,22,13,1,Team Random Map
530203,Martin Ml,21246,1382,MX,93,54,39,5,Team Random Map
2500586,Asta,21253,1382,AR,155,78,77,4,Team Random Map
2242477,黄天当立,21260,1382,CN,219,110,109,9,Team Random Map
2214935,kojo,21262,1382,US,17,6,11,0,Team Random Map
2176057,slUK,21264,1382,ES,60,34,26,1,Team Random Map
2046799,Somersetboy88,21269,1382,GB,88,35,53,3,Team Random Map
1871583,miss orange,21277,1382,CN,56,29,27,4,Team Random Map
202605,JaneDoe,21313,1381,DE,43,28,15,0,Team Random Map
2162966,是86！86上山了！,21343,1381,CN,76,39,37,0,Team Random Map
1832756,Vuil Zwijn,21362,1381,BE,10,8,2,0,Team Random Map
1623921,stevenpacilio,21369,1381,US,116,59,57,0,Team Random Map
481129,Dimmy307,21393,1380,AU,73,38,35,0,Team Random Map
2448386,[GdA] L@nTal,21404,1380,BR,50,27,23,3,Team Random Map
2443791,Tactical Black Bear,21405,1380,CL,13,8,5,1,Team Random Map
2398769,Zumi,21408,1380,CH,33,20,13,1,Team Random Map
2137412,s0j4,21416,1380,AR,11,4,7,0,Team Random Map
2113668,Ganiccus,21418,1380,TR,72,41,31,6,Team Random Map
1260648,Spyro345,21452,1380,US,11,8,3,0,Team Random Map
1207803,HSE? Milfbasher,21455,1380,DE,169,80,89,3,Team Random Map
404765,ToD3vil,21457,1379,DE,39,23,16,2,Team Random Map
1018252,CupcakeServant,21458,1379,FR,43,28,15,1,Team Random Map
2250938,Enzo Star,21487,1379,ES,140,59,81,0,Team Random Map
2057509,Rey David,21491,1379,EC,142,75,67,11,Team Random Map
1999146,UserDodo,21495,1379,IT,236,109,127,6,Team Random Map
1499346,IMr_Laz,21510,1379,TR,85,50,35,4,Team Random Map
279492,Dkastro,21521,1378,CL,11,8,3,0,Team Random Map
1564,Fuhloh,21531,1378,ES,38,23,15,0,Team Random Map
772039,King Schorsch I,21532,1378,CH,61,33,28,0,Team Random Map
2204212,ErnestZ,21555,1378,ES,27,17,10,0,Team Random Map
1858433,木剑游侠,21568,1378,AR,48,19,29,9,Team Random Map
246788,[SFU] S1Lv3r,21595,1377,DE,60,32,28,3,Team Random Map
2554234,Causerom,21606,1377,GB,60,30,30,1,Team Random Map
1911101,allyourbrainz,21624,1377,TR,15,11,4,0,Team Random Map
1137844,Grantwich,21645,1376,US,17,10,7,1,Team Random Map
931837,Tamosbien,21652,1376,CO,80,45,35,6,Team Random Map
2102751,El Quino!,21691,1376,FR,98,58,40,3,Team Random Map
1751472,El Pinguiño,21700,1376,NL,116,62,54,4,Team Random Map
1737935,UberJukeD,21702,1376,AU,57,31,26,2,Team Random Map
1470581,Sir Fishi,21712,1376,NA,145,73,72,7,Team Random Map
24026,Schnorks,21731,1375,DE,141,73,68,1,Team Random Map
579450,yinricristian,21740,1375,US,12,10,2,0,Team Random Map
455597,Victor751,21743,1375,US,39,18,21,1,Team Random Map
331553,carpadelvalle,21769,1375,AR,20,15,5,1,Team Random Map
1054260,RedChallengeR,21785,1374,CA,74,28,46,5,Team Random Map
277575,GingerSnap57,21786,1374,US,56,31,25,1,Team Random Map
840985,cornikeks,21795,1374,DE,18,13,5,1,Team Random Map
711690,Seelentrinker,21803,1374,DE,133,64,69,9,Team Random Map
248824,YE,21807,1374,TW,122,66,56,7,Team Random Map
236936,DeLaVega,21811,1374,BR,49,29,20,0,Team Random Map
2397575,Splinked,21828,1374,GB,24,16,8,0,Team Random Map
1930362,@Corbu,21846,1374,AR,43,22,21,0,Team Random Map
289154,Cram,21861,1374,CA,80,40,40,3,Team Random Map
1214538,eric-fleming18,21862,1374,US,69,32,37,1,Team Random Map
468742,Gunner95,21888,1373,IE,43,25,18,1,Team Random Map
228244,Kanter,21889,1373,FR,176,92,84,1,Team Random Map
224726,Tyb,21898,1373,DE,40,16,24,1,Team Random Map
2049487,TxLast,21911,1373,FR,18,12,6,1,Team Random Map
1853834,HuchoMiguel,21919,1373,FR,142,73,69,1,Team Random Map
612131,Fat & Juan,21948,1372,US,27,18,9,1,Team Random Map
463054,J.Sparrow2005,21955,1372,SE,231,109,122,10,Team Random Map
2237954,Wiful,21976,1372,AR,89,46,43,2,Team Random Map
1350429,Karnack1748,22002,1372,NA,380,186,194,11,Team Random Map
384850,Joeydope,22034,1371,GB,141,76,65,4,Team Random Map
2307906,FernandoIV,22038,1371,AR,18,10,8,0,Team Random Map
311403,TheHeisenberg,22065,1371,MX,23,13,10,1,Team Random Map
306758,Justin Time,22068,1371,DE,64,38,26,0,Team Random Map
1130408,Ace De Uno,22075,1370,US,12,7,5,0,Team Random Map
1074112,indochine8,22076,1370,FR,28,19,9,2,Team Random Map
2698298,wiliamrodriguessk,22096,1370,BR,55,26,29,1,Team Random Map
1987573,Shadow91,22117,1370,AU,114,58,56,1,Team Random Map
1442217,Waddafak,22130,1370,NL,33,18,15,1,Team Random Map
1161564,Rhiiannon4525,22134,1369,NA,44,27,17,4,Team Random Map
892281,Divisibleby0,22142,1369,US,72,43,29,4,Team Random Map
813784,1800000,22145,1369,AU,59,26,33,2,Team Random Map
755623,Raufußkauz,22148,1369,DE,17,7,10,0,Team Random Map
2392158,Aladin,22162,1369,AR,25,13,12,0,Team Random Map
2120758,hi,22173,1369,AR,81,41,40,0,Team Random Map
263528,JeanMich,22209,1368,FR,320,148,172,7,Team Random Map
257770,Zero,22212,1368,TW,60,31,29,2,Team Random Map
438691,Ghost,22223,1368,US,46,27,19,0,Team Random Map
2372891,Manniacx,22234,1368,BR,100,54,46,8,Team Random Map
2030308,LOKI-notdead,22250,1368,AR,98,42,56,2,Team Random Map
1192481,Whatever,22263,1368,SK,14,11,3,0,Team Random Map
231573,Silence,22285,1367,US,31,20,11,0,Team Random Map
2524924,TimZero,22296,1367,US,18,13,5,0,Team Random Map
2001111,Avicenna,22310,1367,DE,68,37,31,1,Team Random Map
327944,Apfelschorly,22318,1367,DE,45,27,18,0,Team Random Map
646682,Phillip,22343,1366,US,65,19,46,0,Team Random Map
422815,Fëanor,22354,1366,US,105,53,52,6,Team Random Map
354275,FlashLIGHT,22375,1366,RU,15,10,5,0,Team Random Map
327157,doneil,22380,1366,US,80,45,35,2,Team Random Map
435969,Sp00Ky,22404,1365,DE,31,19,12,0,Team Random Map
2738299,ReaperZuul,22406,1365,CA,37,17,20,0,Team Random Map
2479874,choramais,22412,1365,CL,72,32,40,1,Team Random Map
2047531,Core Ona,22427,1365,CH,131,65,66,1,Team Random Map
336551,Crixus,22433,1365,IN,147,77,70,19,Team Random Map
1467424,Voradion,22438,1365,NA,36,23,13,1,Team Random Map
2125674,Waldorf,22481,1364,DE,21,14,7,0,Team Random Map
2078521,Tomoki,22485,1364,TW,75,41,34,1,Team Random Map
836201,Achmatova,22512,1363,DE,147,71,76,17,Team Random Map
677404,Allagash,22518,1363,US,45,21,24,2,Team Random Map
676532,TBK | Stig_Bubblecard,22519,1363,GB,34,17,17,1,Team Random Map
2240225,AzgOn,22543,1363,AR,12,10,2,0,Team Random Map
1953008,KinG WaSSeRaHNo,22553,1363,FR,180,90,90,7,Team Random Map
1556285,Sessto,22563,1363,DE,12,9,3,0,Team Random Map
1291514,domfleif,22569,1363,US,81,40,41,0,Team Random Map
256180,storm_andy,22586,1362,GB,132,64,68,8,Team Random Map
464326,Pelatros,22594,1362,SE,149,72,77,5,Team Random Map
2439588,Noweehustl,22601,1362,US,15,10,5,0,Team Random Map
2385419,WiSeMaN,22602,1362,TH,27,16,11,2,Team Random Map
1476609,Failed Math Test,22632,1362,CA,186,93,93,0,Team Random Map
285275,livonjm,22641,1361,AR,24,15,9,0,Team Random Map
839516,Roi des perdants,22652,1361,FR,74,38,36,7,Team Random Map
829949,feraqz13,22653,1361,MX,41,16,25,1,Team Random Map
607931,Jan,22656,1361,NL,59,32,27,0,Team Random Map
308499,DaveX.ve,22700,1361,MX,334,159,175,10,Team Random Map
810388,Brasidas,22713,1360,FR,23,15,8,1,Team Random Map
796456,wojdka,22714,1360,FR,59,29,30,2,Team Random Map
1814883,Crüna,22758,1360,DE,38,16,22,0,Team Random Map
1652721,SkwAnchy,22762,1360,AR,160,72,88,7,Team Random Map
1314885,Gruffalo,22774,1360,DE,18,8,10,1,Team Random Map
558907,Yirgacheffe,22797,1359,CA,136,68,68,4,Team Random Map
544830,Supertramp,22799,1359,DE,123,66,57,5,Team Random Map
955231,Locke,22850,1358,DE,33,17,16,2,Team Random Map
239242,sheepinbigcity,22867,1358,US,102,33,69,7,Team Random Map
2504239,xVDarkShadowVx,22880,1358,DE,13,9,4,0,Team Random Map
2132665,Joaklamenace,22893,1358,FR,99,50,49,1,Team Random Map
219734,ridergr,22904,1358,GR,30,14,16,0,Team Random Map
569063,santiru01,22932,1357,CO,55,32,23,0,Team Random Map
1585588,AonGA,22967,1357,NA,112,53,59,23,Team Random Map
1486946,TrueDisplay,22971,1357,CA,125,65,60,4,Team Random Map
1337206,Dundergubben,22976,1357,SE,131,46,85,4,Team Random Map
1039081,Maxzonz,22982,1356,FR,248,125,123,4,Team Random Map
909039,Kixkal,22986,1356,GB,17,10,7,0,Team Random Map
871905,avalancha,22989,1356,DE,51,32,19,2,Team Random Map
241906,Lord Morest,23001,1356,CO,31,17,14,2,Team Random Map
2713994,Bro,23006,1356,AR,27,15,12,0,Team Random Map
2078624,Eraka,23036,1356,BE,41,19,22,1,Team Random Map
1990202,GOOLFYZERA,23041,1356,BR,37,23,14,4,Team Random Map
1653228,merhimoro,23050,1356,PT,99,46,53,3,Team Random Map
2462191,Sehzade,23092,1355,AT,30,19,11,2,Team Random Map
2168571,KapEr,23104,1355,SK,47,29,18,0,Team Random Map
234854,Henburger,23160,1354,DE,106,54,52,2,Team Random Map
2640385,erudii,23163,1354,GB,43,26,17,0,Team Random Map
2570455,_warrior,23166,1354,PR,106,54,52,0,Team Random Map
1879727,Mauruss,23188,1354,IT,38,22,16,0,Team Random Map
1529411,Heinkel_Greif,23195,1354,DE,11,5,6,1,Team Random Map
1448632,Dadew,23198,1354,FR,92,52,40,0,Team Random Map
1227262,snndmr,23202,1354,TR,23,14,9,1,Team Random Map
1725813,sverre-hellem,23255,1353,NO,77,42,35,14,Team Random Map
1356986,ahanbury,23266,1353,GB,125,60,65,3,Team Random Map
1229442,Stjernegris,23271,1353,NO,43,23,20,0,Team Random Map
865725,Nuremberg,23283,1352,US,18,10,8,2,Team Random Map
991798,AYAYA,23354,1351,DE,158,81,77,3,Team Random Map
569411,LuckYLuke2401,23369,1351,DE,164,83,81,30,Team Random Map
872652,cyaozu,23434,1350,JP,237,113,124,4,Team Random Map
2320666,Legalorn,23468,1350,CH,19,12,7,0,Team Random Map
2217027,jr.silos,23473,1350,MX,34,19,15,0,Team Random Map
2042635,simplegaminginc,23477,1350,US,90,49,41,5,Team Random Map
1927177,LiLTouch,23484,1350,FR,23,18,5,1,Team Random Map
770807,Abtreiber,23517,1349,DE,10,8,2,0,Team Random Map
2523227,XandreeA,23534,1349,TR,21,11,10,1,Team Random Map
2482898,Abyss,23536,1349,ES,15,11,4,0,Team Random Map
2341611,Toxxice,23544,1349,FR,61,27,34,2,Team Random Map
2042645,Hoy,23553,1349,US,87,47,40,1,Team Random Map
2033790,宝剑X,23555,1349,CN,124,57,67,2,Team Random Map
2014232,Cookiê Jar*,23556,1349,TR,13,7,6,0,Team Random Map
1949400,Jaimico,23557,1349,AR,38,18,20,1,Team Random Map
1192801,nugibaba,23581,1349,TR,264,127,137,25,Team Random Map
818613,LSW,23593,1348,SE,77,41,36,0,Team Random Map
1999180,TheOlympusTitan,23632,1348,CA,128,63,65,2,Team Random Map
1426939,PussyHunter,23651,1348,EE,121,52,69,0,Team Random Map
2689764,Berserker_423,23688,1347,NZ,14,9,5,2,Team Random Map
868494,erickdv32,23731,1346,MX,33,22,11,0,Team Random Map
2250002,melonne,23754,1346,FR,34,18,16,0,Team Random Map
1754413,Sir Face,23773,1346,CA,13,8,5,1,Team Random Map
1541055,twitch.com/ageofempiresturkiye,23776,1346,TR,46,26,20,0,Team Random Map
2583795,LeOwNs_,23810,1345,BR,15,9,6,1,Team Random Map
1680714,rwj0003,23844,1345,US,27,19,8,2,Team Random Map
1637826,Necessary Evil,23847,1345,PE,35,20,15,0,Team Random Map
1417305,Senzu,23850,1345,FR,97,47,50,5,Team Random Map
914670,Johny Cage Cagali 66X,23864,1344,SK,277,121,156,9,Team Random Map
888527,Sli0n,23867,1344,LU,249,116,133,4,Team Random Map
455039,Jasper,23881,1344,NL,57,31,26,0,Team Random Map
2012192,darth yeyo,23904,1344,ES,26,16,10,0,Team Random Map
1727173,vaughaN,23908,1344,DK,124,55,69,1,Team Random Map
299980,The Wolf King,23913,1344,US,29,17,12,0,Team Random Map
1061992,Matoutou27,23919,1343,CA,315,131,184,7,Team Random Map
2143093,William Lives,23959,1343,ES,31,22,9,1,Team Random Map
1029543,moskon95,23992,1342,AT,102,55,47,4,Team Random Map
2089111,kevs_234,24035,1342,AR,45,20,25,2,Team Random Map
1258939,WonessaTV,24055,1342,ES,50,26,24,0,Team Random Map
2351138,MrEricsson6277,24092,1341,NA,16,8,8,3,Team Random Map
1538451,NemesiS,24117,1341,PE,17,11,6,2,Team Random Map
608232,MAXYVEEEEE,24143,1340,US,54,30,24,5,Team Random Map
323976,Cryptosaurus,24192,1340,MX,103,49,54,6,Team Random Map
405725,Niczer,24222,1339,CL,99,48,51,4,Team Random Map
2315093,Klaus,24232,1339,AT,33,22,11,0,Team Random Map
1799494,Erotischer Heizofen,24252,1339,DE,154,70,84,8,Team Random Map
1324815,baroced,24268,1339,FR,69,34,35,0,Team Random Map
534108,Deaca0,24292,1338,DE,225,100,125,5,Team Random Map
2030454,Paitaon,24319,1338,BR,53,28,25,5,Team Random Map
221529,BioPanzer,24321,1338,ES,29,18,11,0,Team Random Map
1882990,Rilexeon,24328,1338,AU,10,7,3,0,Team Random Map
1866723,Lucien.Lu,24330,1338,CN,22,12,10,1,Team Random Map
333016,[Supersweet1600]Hexenkoenig,24334,1338,DE,45,28,17,0,Team Random Map
1784101,Sir Kinobix,24335,1338,FR,12,8,4,0,Team Random Map
1685587,Ynghlingar,24340,1338,IT,70,40,30,1,Team Random Map
1001990,Lord Petrus,24358,1337,ID,37,17,20,4,Team Random Map
583443,SOILLGILL,24365,1337,US,41,18,23,2,Team Random Map
1838363,Darcturius,24404,1337,FR,189,91,98,2,Team Random Map
1441823,twitch.tv/dreeze,24417,1337,DE,11,6,5,2,Team Random Map
2371662,Low.d3t4ils,24460,1336,BR,76,33,43,3,Team Random Map
1767012,KaiZerShift,24477,1336,FR,74,34,40,1,Team Random Map
1496069,Nico le conquer,24484,1336,FR,52,23,29,0,Team Random Map
1314131,Decize,24490,1336,SE,52,32,20,0,Team Random Map
256758,thedrunkenbull,24503,1335,IE,10,9,1,2,Team Random Map
752392,Master,24505,1335,RU,225,93,132,4,Team Random Map
2019220,Locura,24546,1335,AR,60,31,29,0,Team Random Map
1798437,Jenes Bookwood,24553,1335,DE,135,60,75,1,Team Random Map
1320149,harsh.uke,24564,1335,IN,183,65,118,13,Team Random Map
1269171,Uli,24565,1335,DE,19,13,6,0,Team Random Map
1109645,faubox,24570,1334,CO,170,80,90,8,Team Random Map
630650,Augusto,24582,1334,AR,53,23,30,1,Team Random Map
408396,JoelAndYou,24589,1334,CA,43,20,23,3,Team Random Map
2586578,Law,24590,1334,DE,107,56,51,4,Team Random Map
2125541,Belisario430,24608,1334,IT,11,5,6,0,Team Random Map
1815184,Misal,24623,1334,TR,185,88,97,0,Team Random Map
1496681,Coocoon,24629,1334,FR,101,50,51,6,Team Random Map
1468953,FrostyEh6437,24630,1334,NA,58,32,26,1,Team Random Map
1150515,Sef Cass,24636,1333,US,25,13,12,0,Team Random Map
2318858,eygan,24669,1333,AR,31,16,15,1,Team Random Map
2024813,EazyT,24686,1333,FR,83,41,42,1,Team Random Map
1923441,Lauchaaaaaaaa,24689,1333,AR,36,15,21,2,Team Random Map
1871952,Aurora,24690,1333,CN,16,7,9,1,Team Random Map
206174,witchblade108,24714,1332,IE,36,24,12,1,Team Random Map
769905,joco71,24720,1332,RO,52,29,23,2,Team Random Map
2491531,bilodeau.maxence,24745,1332,US,54,29,25,3,Team Random Map
1976255,paddy2712,24766,1332,DE,65,36,29,1,Team Random Map
1509679,TangoFoxtrot,24784,1332,FR,40,23,17,0,Team Random Map
2456458,KAMI MASTER,24832,1331,US,16,10,6,0,Team Random Map
2352847,xwuichox,24835,1331,MX,32,16,16,0,Team Random Map
2278111,Al-Muzaffar Umar,24837,1331,US,31,20,11,0,Team Random Map
347760,Slobodan F.,24850,1331,DE,151,42,109,4,Team Random Map
1579791,Jacques Chirac,24859,1331,FR,219,95,124,4,Team Random Map
301461,dARK Techno,24864,1331,AR,24,15,9,1,Team Random Map
1120980,阿尔托莉雅,24871,1330,CN,71,34,37,6,Team Random Map
275547,SONICneedsRINGS,24873,1330,NA,38,21,17,4,Team Random Map
966134,HS_Piccolo,24875,1330,DE,98,50,48,6,Team Random Map
930223,ferret99,24878,1330,US,19,14,5,0,Team Random Map
466481,diegogobellog,24898,1330,NA,82,32,50,6,Team Random Map
2467012,Dicc Pointy Like Arrow,24907,1330,US,76,42,34,1,Team Random Map
172932,APPA,24918,1330,US,13,7,6,0,Team Random Map
1988976,gabicarp16,24929,1330,AR,23,11,12,1,Team Random Map
125198,LookdeeZElemelons,24955,1329,CA,67,38,29,0,Team Random Map
2170293,youisgoodest,24989,1329,HK,108,53,55,1,Team Random Map
873906,ReinerZufall,25028,1328,DE,10,9,1,0,Team Random Map
631680,Jenkemite,25035,1328,CA,48,29,19,1,Team Random Map
2710179,enpe,25046,1328,MY,13,8,5,0,Team Random Map
2493659,[J.C.],25051,1328,AR,11,9,2,1,Team Random Map
1576653,Maverick Fish,25071,1328,FR,21,10,11,0,Team Random Map
215372,Csukla,25085,1328,HU,85,45,40,7,Team Random Map
639831,Sachwalter von der Dogelweide,25160,1326,AT,96,49,47,4,Team Random Map
238837,Finndu,25163,1326,DE,81,47,34,3,Team Random Map
455041,king_leoncio,25169,1326,GB,193,74,119,11,Team Random Map
2724143,StormBreakeR,25173,1326,BR,12,8,4,0,Team Random Map
1499701,School47,25209,1326,RU,10,6,4,0,Team Random Map
1372868,Ω Migate no Omega Ω,25211,1326,CL,196,93,103,11,Team Random Map
2273408,Pker,25249,1325,CA,32,18,14,0,Team Random Map
1937066,bhaijaan,25258,1325,GB,15,7,8,0,Team Random Map
2503168,Scarecrow Boat,25311,1324,US,15,10,5,1,Team Random Map
2373574,Last Man Dancing,25313,1324,US,15,10,5,0,Team Random Map
1771373,Gordon Freeman,25337,1324,AR,54,21,33,3,Team Random Map
1093538,Surströmming,25353,1323,DE,11,7,4,0,Team Random Map
259198,TheNiero,25360,1323,NA,15,10,5,0,Team Random Map
433931,Kancha,25373,1323,IN,44,22,22,7,Team Random Map
2449810,Vinhfinity,25385,1323,CA,30,19,11,0,Team Random Map
1303681,Arroused,25426,1323,GB,54,24,30,7,Team Random Map
277689,Alpac,25434,1322,TR,25,13,12,0,Team Random Map
722038,Snaptrax,25442,1322,DE,69,36,33,1,Team Random Map
504598,amukara,25456,1322,NA,45,28,17,0,Team Random Map
456965,G0L3M XIV,25459,1322,IT,268,119,149,17,Team Random Map
397895,R.I.P,25470,1322,US,240,99,141,8,Team Random Map
2474225,olorin,25473,1322,TR,17,9,8,0,Team Random Map
385322,LG_Blace,25475,1322,DE,99,45,54,1,Team Random Map
309580,EdibleCrayons,25493,1322,US,10,6,4,3,Team Random Map
1337145,TheLegend27,25498,1322,US,24,12,12,0,Team Random Map
1336888,Silver Boi,25499,1322,DE,44,24,20,1,Team Random Map
965546,Dild/or☭,25508,1321,MX,63,31,32,3,Team Random Map
958432,Nicanor,25509,1321,AR,10,8,2,0,Team Random Map
2481045,盐巴,25538,1321,CN,29,20,9,1,Team Random Map
1830062,Brunoganster25,25554,1321,MX,11,9,2,0,Team Random Map
1400559,Kili,25563,1321,DE,10,9,1,0,Team Random Map
470566,jonahanderson12,25592,1320,US,65,26,39,0,Team Random Map
2531010,robertmarin91,25600,1320,ES,84,45,39,4,Team Random Map
1938216,JakeyBoy,25617,1320,GB,28,16,12,3,Team Random Map
1871336,P@yne,25621,1320,US,58,28,30,0,Team Random Map
1711670,warren11038,25625,1320,AU,127,58,69,2,Team Random Map
325577,walrusman7777,25627,1320,US,57,32,25,0,Team Random Map
321769,Young Pig,25629,1320,NZ,26,15,11,2,Team Random Map
1555424,jorgeanmora,25630,1320,AR,283,122,161,38,Team Random Map
837698,Dolohov,25659,1319,FR,83,39,44,1,Team Random Map
554405,AidsChicken,25669,1319,MX,17,11,6,0,Team Random Map
2307945,eldurazno,25687,1319,CL,95,49,46,2,Team Random Map
2131071,Vidame,25695,1319,ES,12,3,9,0,Team Random Map
881421,pisrael,25737,1318,BR,15,8,7,1,Team Random Map
2318817,seankilburn87,25763,1318,GB,148,69,79,4,Team Random Map
1512062,Antjies,25789,1318,BE,95,49,46,10,Team Random Map
1273349,DarthDoge El Bravo,25795,1318,ES,79,39,40,0,Team Random Map
1038335,Twizzler,25801,1317,CA,45,21,24,2,Team Random Map
822820,hits,25808,1317,ES,105,42,63,17,Team Random Map
519739,YMI2L8,25817,1317,DE,34,20,14,1,Team Random Map
475048,The Majestic Thumb,25819,1317,AU,33,17,16,0,Team Random Map
1360057,Proyce,25858,1317,AR,18,13,5,0,Team Random Map
943812,Badblood,25868,1316,NO,77,44,33,6,Team Random Map
684070,Stoperu,25876,1316,US,108,55,53,4,Team Random Map
550134,Ricola,25881,1316,DE,22,12,10,1,Team Random Map
2158962,Patredway,25903,1316,MQ,88,49,39,1,Team Random Map
2153924,Emoli,25904,1316,TR,16,8,8,3,Team Random Map
2087049,DeviL MadeX,25908,1316,AR,39,18,21,1,Team Random Map
312370,Cuauhpilli,25922,1316,MX,171,77,94,9,Team Random Map
1340141,hcombaz,25931,1316,FR,166,84,82,7,Team Random Map
700569,Unr3aL,25944,1315,DE,81,41,40,1,Team Random Map
245924,Kaiser Maximus,25945,1315,DE,51,28,23,1,Team Random Map
2317847,Christophe,25958,1315,BE,170,84,86,3,Team Random Map
2211552,Tomaaaszek,25965,1315,NA,24,15,9,1,Team Random Map
307409,Rigo,25991,1315,CL,84,42,42,7,Team Random Map
669535,wangzhongjia,26007,1314,CN,394,177,217,14,Team Random Map
53462,Robert_Pwns?,26016,1314,AU,54,27,27,4,Team Random Map
439084,El Mudo,26018,1314,EE,194,93,101,4,Team Random Map
2129379,X3st4,26033,1314,ES,95,54,41,3,Team Random Map
2034458,Haiskoahanta,26041,1314,DE,67,34,33,2,Team Random Map
1898874,ti cochon malandrin le marsouin,26049,1314,FR,24,13,11,3,Team Random Map
1550018,LucianoGil,26058,1314,BR,34,22,12,3,Team Random Map
871747,Gutentag,26080,1313,TW,66,33,33,0,Team Random Map
537386,Chicken Thuggets,26088,1313,AU,11,7,4,0,Team Random Map
499560,BrYaN,26092,1313,HK,81,38,43,4,Team Random Map
2630238,MaTTs,26096,1313,AR,22,15,7,1,Team Random Map
511185,francoisdu38,26146,1312,FR,115,52,63,3,Team Random Map
2300492,芽芽皮皮,26162,1312,CN,75,43,32,1,Team Random Map
2005413,colonel_andrews,26174,1312,US,51,23,28,4,Team Random Map
1221232,Timoxa1,26196,1312,RU,101,47,54,1,Team Random Map
1029466,SuperPytho,26200,1311,FR,78,42,36,2,Team Random Map
720855,Buzzplash ⭕⃤,26206,1311,DE,54,28,26,1,Team Random Map
1980455,Rey Escorpion,26244,1311,AR,11,7,4,6,Team Random Map
1323762,Jyxius,26263,1311,NL,67,37,30,0,Team Random Map
1021950,lynxloco,26275,1310,NL,37,18,19,1,Team Random Map
1718331,boyar_orlov,26323,1310,FR,107,56,51,6,Team Random Map
1348693,AdriánGG,26331,1310,AR,107,53,54,0,Team Random Map
248784,Igor*,26345,1309,BR,46,26,20,0,Team Random Map
226314,Arkarius,26351,1309,DE,21,11,10,1,Team Random Map
1958464,Zkenpachi5,26378,1309,TR,81,35,46,3,Team Random Map
1341009,alcohlik,26401,1309,FR,54,26,28,0,Team Random Map
1309663,Atronach6885,26402,1309,NA,40,24,16,1,Team Random Map
1164029,Miles Edgeworth,26404,1308,JP,11,6,5,0,Team Random Map
261332,Blewduck,26413,1308,US,77,33,44,7,Team Random Map
453467,Karin Ritter,26424,1308,DE,287,134,153,10,Team Random Map
2737022,⭕⃤  ONE TAP GOD,26427,1308,TR,15,9,6,0,Team Random Map
2572713,Dharokzz,26434,1308,NA,11,6,5,0,Team Random Map
177790,witchdoctor,26438,1308,DE,240,114,126,5,Team Random Map
2476892,Skelter,26440,1308,AR,17,10,7,1,Team Random Map
2234384,Tanjiro BoomBoom,26453,1308,IN,143,61,82,8,Team Random Map
2268124,Roflorz,26527,1307,NL,10,7,3,1,Team Random Map
2091501,ser,26534,1307,AR,54,25,29,2,Team Random Map
544321,Galnar,26578,1306,DE,17,11,6,0,Team Random Map
2080649,tinoso15,26611,1306,ES,62,39,23,0,Team Random Map
1136813,Raiko,26637,1305,FR,144,72,72,6,Team Random Map
1115585,GoldenWings,26639,1305,GB,52,29,23,0,Team Random Map
226646,D3vFlash,26666,1305,DE,124,61,63,6,Team Random Map
2175846,THE INVESTIBETOR,26686,1305,BG,19,10,9,1,Team Random Map
218021,Algren6453,26711,1305,PL,12,8,4,0,Team Random Map
742640,dvlopez41,26736,1304,HN,51,22,29,2,Team Random Map
509383,Stewie,26742,1304,DE,71,37,34,1,Team Random Map
2251003,CJW,26762,1304,DE,63,36,27,2,Team Random Map
2319777,ReloaDreamS,26851,1303,CO,33,18,15,4,Team Random Map
2078173,Vietnam,26865,1303,DE,25,12,13,0,Team Random Map
2279369,Eagleproxx11,26938,1302,US,22,14,8,0,Team Random Map
2009144,Yaif_,26950,1302,CR,105,58,47,3,Team Random Map
1105142,Tungdil,26960,1302,NL,36,19,17,1,Team Random Map
1284292,DARTooT,26971,1302,MX,10,8,2,0,Team Random Map
1030715,Oneilos,26978,1301,FR,283,131,152,15,Team Random Map
1082,Pellikka,26979,1301,SE,107,52,55,1,Team Random Map
2474048,huddyham2,27008,1301,NA,23,9,14,2,Team Random Map
2254198,Hamilton_Mourão,27016,1301,BR,25,9,16,0,Team Random Map
2060534,husz.g.b,27025,1301,HU,191,88,103,12,Team Random Map
1971589,mclovin06,27032,1301,TR,78,31,47,3,Team Random Map
1602656,pauledouardo,27041,1301,FR,89,49,40,0,Team Random Map
2563149,[LoD] Lord of Doom,27091,1300,DE,32,18,14,0,Team Random Map
2128134,samzzz_,27106,1300,FR,12,7,5,0,Team Random Map
1245884,kimleonh,27143,1300,DE,173,81,92,17,Team Random Map
90751,Akabreaker,27171,1299,ES,14,10,4,0,Team Random Map
2111072,THOR,27193,1299,BR,12,8,4,0,Team Random Map
2002153,[ArD] JHH CONNIES 2,27194,1299,UY,101,41,60,4,Team Random Map
1995536,jaripdm,27195,1299,DE,20,15,5,0,Team Random Map
1899983,PUCH,27201,1299,AR,41,20,21,0,Team Random Map
1655383,Pat6923,27206,1299,NA,17,9,8,6,Team Random Map
309814,RedBaronV,27210,1299,MX,25,16,9,0,Team Random Map
1419541,Matt Manson,27211,1299,UY,13,8,5,1,Team Random Map
1372886,benoit.maggi,27214,1299,FR,14,7,7,0,Team Random Map
242469,schwazza,27243,1298,DE,39,21,18,0,Team Random Map
583310,Axzed,27244,1298,DE,14,9,5,0,Team Random Map
2503495,aljuarisimi55,27260,1298,NA,69,40,29,3,Team Random Map
2442267,luke-d,27264,1298,DE,67,35,32,0,Team Random Map
2411546,滅殺三段,27268,1298,TW,101,50,51,1,Team Random Map
2289731,Seifou,27274,1298,DZ,26,13,13,1,Team Random Map
1887269,real terminator,27291,1298,BE,52,27,25,0,Team Random Map
1716736,Papinien,27300,1298,FR,40,23,17,0,Team Random Map
305995,aoe2hostage,27307,1298,US,47,28,19,5,Team Random Map
651651,Metum,27323,1297,DE,10,5,5,0,Team Random Map
2484627,ricki-mueller,27338,1297,DE,12,7,5,0,Team Random Map
2371762,sha,27346,1297,TR,68,36,32,2,Team Random Map
1488270,itsuka,27375,1297,CN,99,51,48,5,Team Random Map
995040,paradisebird,27383,1296,FR,44,26,18,1,Team Random Map
887904,Failoh,27386,1296,LU,185,77,108,4,Team Random Map
2567249,hesiode,27401,1296,FR,12,8,4,1,Team Random Map
220754,UnitedTFT,27425,1296,DE,31,18,13,1,Team Random Map
1006630,Boanerges♂,27444,1295,CL,12,5,7,0,Team Random Map
213114,hiiwave,27445,1295,TW,13,9,4,0,Team Random Map
839164,Butt Pirate,27446,1295,MK,150,75,75,5,Team Random Map
244188,Gizmo-,27454,1295,FR,82,44,38,4,Team Random Map
1987123,Tugga,27485,1295,AU,56,26,30,1,Team Random Map
1671554,Laffranchizi,27498,1295,FR,123,64,59,3,Team Random Map
249978,AbrahamXY,27525,1294,JO,57,28,29,3,Team Random Map
2343036,"Alan, así, simple",27553,1294,AR,134,50,84,2,Team Random Map
2217202,El Duderino,27557,1294,AR,48,13,35,0,Team Random Map
1628201,k11,27568,1294,FR,34,18,16,0,Team Random Map
1414855,ArgentoXX,27573,1294,ES,39,21,18,2,Team Random Map
1210770,Fennelation,27577,1294,DE,173,69,104,15,Team Random Map
1175238,JosPunch,27581,1293,FR,173,88,85,8,Team Random Map
949767,koky,27587,1293,FR,387,185,202,26,Team Random Map
259406,Joaksss,27593,1293,ES,95,47,48,2,Team Random Map
622742,GreenFire711,27597,1293,DE,113,55,58,3,Team Random Map
2569299,Dumbhill,27607,1293,TR,81,42,39,4,Team Random Map
2316759,Von Baron,27615,1293,AU,118,63,55,9,Team Random Map
2078830,EL COMANDANTE .Gamdom.com,27625,1293,AR,31,19,12,1,Team Random Map
1989661,tyuriniyu,27633,1293,RU,26,14,12,3,Team Random Map
1815280,GIS Prof,27642,1293,DE,30,18,12,0,Team Random Map
299796,karlonx0_,27647,1293,CL,20,11,9,0,Team Random Map
1157221,Amenhotep,27652,1292,US,76,33,43,2,Team Random Map
684598,Delay no more,27663,1292,HK,303,134,169,42,Team Random Map
17269,Canderous Ordo,27666,1292,BE,107,50,57,0,Team Random Map
2071195,Cranqdex,27694,1292,AT,14,7,7,0,Team Random Map
1994803,wantbest?,27698,1292,TR,31,15,16,0,Team Random Map
1250754,RussianSlushie,27721,1292,US,58,25,33,0,Team Random Map
1222602,michaelneukom,27722,1292,CH,68,32,36,9,Team Random Map
786107,Bloodex,27736,1291,DE,110,56,54,1,Team Random Map
247842,MaV,27740,1291,SE,78,41,37,1,Team Random Map
1656561,Maths=Cool,27781,1291,AU,71,26,45,1,Team Random Map
265793,LogyFromEarth,27795,1290,GB,158,77,81,12,Team Random Map
2748022,Reo_月小凜,27810,1290,TW,29,15,14,2,Team Random Map
1484723,LUCAS,27845,1290,US,30,13,17,0,Team Random Map
829305,Knobscaper,27855,1289,US,81,37,44,0,Team Random Map
2683445,Кализо,27875,1289,AR,15,10,5,0,Team Random Map
1520359,Trito,27913,1289,FR,64,34,30,1,Team Random Map
1484464,Tancrede,27915,1289,NZ,100,52,48,2,Team Random Map
275612,sirvaloso,27926,1288,CH,12,7,5,0,Team Random Map
597214,idefix,27939,1288,FI,51,28,23,1,Team Random Map
2400988,Nepia47,27958,1288,GB,21,12,9,0,Team Random Map
2085680,Fo9ma,27972,1288,DE,111,58,53,3,Team Random Map
1436445,Pillepalle,27995,1288,NA,79,40,39,10,Team Random Map
1386043,xaleate,27997,1288,AU,51,25,26,5,Team Random Map
412753,Oceanchief,28012,1287,US,121,64,57,1,Team Random Map
1247911,cpmcarlinda,28064,1287,ES,150,64,86,3,Team Random Map
1005266,kh,28071,1286,DE,43,21,22,2,Team Random Map
400498,G0ld13,28091,1286,US,23,12,11,1,Team Random Map
2512314,ScarfacePR,28094,1286,BR,25,14,11,1,Team Random Map
1843934,RenarDesSurfaces,28124,1286,FR,11,8,3,0,Team Random Map
1197882,BUZZARD,28140,1286,AU,99,54,45,3,Team Random Map
902035,Baxa,28147,1285,HU,12,9,3,0,Team Random Map
2544065,Player.Conqueror,28171,1285,ES,10,7,3,0,Team Random Map
2269463,squishyboo,28187,1285,IT,28,14,14,0,Team Random Map
2165687,GregTheGreatest,28253,1284,AT,45,23,22,3,Team Random Map
2140788,hoitloiftska,28255,1284,DE,70,39,31,4,Team Random Map
1073514,FNx,28289,1283,ES,35,24,11,0,Team Random Map
1033913,i ruin game,28291,1283,US,45,23,22,4,Team Random Map
903333,NarkOz02,28294,1283,NA,206,88,118,3,Team Random Map
824236,Sylo,28299,1283,BG,54,30,24,0,Team Random Map
474768,Cappatita,28308,1283,PE,236,110,126,6,Team Random Map
2402115,ricovandegevel,28314,1283,NL,28,12,16,1,Team Random Map
2078983,GreedIsGuud,28324,1283,GB,18,10,8,0,Team Random Map
2053747,lsriley77,28325,1283,US,146,70,76,5,Team Random Map
2016509,FreddieMorecurry,28327,1283,US,31,16,15,3,Team Random Map
1943689,Shirojj,28330,1283,UY,86,41,45,5,Team Random Map
1837217,simondoof,28410,1282,DE,24,16,8,0,Team Random Map
1475193,Ben voyons !,28419,1282,FR,79,42,37,4,Team Random Map
696621,P4LAD1N6655,28435,1281,NA,38,20,18,1,Team Random Map
1721111,BriBri,28479,1281,FR,55,24,31,1,Team Random Map
1172846,Mozzerella Deadfox,28492,1280,CH,15,9,6,0,Team Random Map
866296,Bone,28500,1280,FR,31,13,18,2,Team Random Map
727944,Lubodi,28504,1280,CR,104,44,60,4,Team Random Map
1140373,sam,28575,1279,AU,23,8,15,1,Team Random Map
271534,Asher da KK,28581,1279,US,75,38,37,2,Team Random Map
749765,wouter,28585,1279,NL,27,14,13,0,Team Random Map
538256,Ouroboros,28598,1279,NL,40,22,18,4,Team Random Map
348383,King_NICKO,28626,1279,US,14,10,4,0,Team Random Map
1902558,kamaraden,28631,1279,AR,37,17,20,3,Team Random Map
1314588,Fjalknwulf,28652,1279,DE,18,9,9,0,Team Random Map
37294,Azka Chan,28670,1278,CL,17,10,7,0,Team Random Map
2295964,MambO-.,28684,1278,AR,99,48,51,10,Team Random Map
1462175,el_Commandante,28714,1278,DE,153,71,82,3,Team Random Map
53347,Tlaloc,28718,1278,AU,20,6,14,0,Team Random Map
2647981,major stronke,28747,1277,FI,42,16,26,0,Team Random Map
2502828,sipidik,28756,1277,TR,165,74,91,10,Team Random Map
1499514,skintel,28796,1277,DE,18,11,7,0,Team Random Map
1447753,Theelesar,28797,1277,TR,122,59,63,6,Team Random Map
1147970,GUZA,28806,1276,NL,151,71,80,8,Team Random Map
260356,Ozorius,28813,1276,ES,42,20,22,2,Team Random Map
637761,El Azote,28821,1276,CO,112,56,56,1,Team Random Map
245114,adorerofblood,28822,1276,ZA,11,6,5,0,Team Random Map
2425362,Tu7e,28842,1276,AR,103,48,55,1,Team Random Map
2105675,Lampiao,28853,1276,BR,28,17,11,1,Team Random Map
1424492,Benjefarm4036,28882,1276,NA,59,32,27,0,Team Random Map
622840,takedown66,28900,1275,US,44,27,17,2,Team Random Map
156942,Ambro,28907,1275,SE,96,46,50,0,Team Random Map
2250195,Kuken,28922,1275,SE,13,10,3,0,Team Random Map
49725,WoffeZ,28923,1275,SE,41,22,19,1,Team Random Map
2014710,CacıkYiyenZombi,28930,1275,TR,53,26,27,0,Team Random Map
2666160,TigerShark,28993,1274,IN,32,18,14,0,Team Random Map
374692,Sheogorath,29006,1274,DE,41,23,18,0,Team Random Map
1642754,plumbum,29036,1274,DE,18,11,7,4,Team Random Map
1187099,maemze,29052,1274,CH,10,7,3,0,Team Random Map
260043,grund-wascht,29066,1273,DE,19,14,5,0,Team Random Map
380759,HamsterofDoom,29102,1273,US,104,54,50,1,Team Random Map
2326039,Mashy,29106,1273,AU,13,7,6,0,Team Random Map
2185271,Richard de Bourgogne,29117,1273,CA,13,10,3,0,Team Random Map
1838884,NechToNaYindy,29132,1273,CZ,65,32,33,1,Team Random Map
1495957,JÖPPÖ,29146,1273,FI,10,6,4,0,Team Random Map
1314026,Autopumpe,29149,1273,DE,280,122,158,1,Team Random Map
1283457,rogerio,29151,1273,CH,241,116,125,3,Team Random Map
244364,mills and cookies,29170,1272,GB,65,33,32,2,Team Random Map
2256377,BOBO,29196,1272,US,33,12,21,1,Team Random Map
1866884,duoble.2,29219,1272,AR,86,36,50,3,Team Random Map
2670640,Dressman,29263,1271,SE,31,12,19,0,Team Random Map
2558779,DocCox,29267,1271,US,16,12,4,0,Team Random Map
1716858,bzzbzz,29308,1271,FR,30,16,14,0,Team Random Map
2544879,xus90c,29348,1270,ES,50,25,25,0,Team Random Map
2509033,Hintdawg03,29350,1270,NZ,20,13,7,0,Team Random Map
1719530,Tyrune,29378,1270,DE,13,9,4,0,Team Random Map
224368,HassLiebe,29429,1269,DE,93,49,44,0,Team Random Map
359878,Kesari superman,29435,1269,IN,216,103,113,19,Team Random Map
1857817,Otseliini,29451,1269,NA,30,15,15,0,Team Random Map
1214902,Chris Hansen,29476,1269,CA,26,17,9,1,Team Random Map
933974,ImLeffe,29481,1268,SE,64,28,36,0,Team Random Map
130765,DICTATOR,29497,1268,RU,221,92,129,11,Team Random Map
2029014,Killy,29521,1268,AR,18,8,10,0,Team Random Map
1864890,ARS-ALU,29527,1268,IT,24,14,10,0,Team Random Map
1753189,Custom Action,29532,1268,DE,17,12,5,3,Team Random Map
1352406,Re1gnover,29541,1268,US,16,12,4,0,Team Random Map
942683,Z_od,29552,1267,FR,43,25,18,0,Team Random Map
467350,Sirean_army,29564,1267,US,11,8,3,0,Team Random Map
397456,Tribry,29573,1267,CA,33,19,14,0,Team Random Map
2405170,Vayovio,29578,1267,NL,11,4,7,1,Team Random Map
1957410,Charles,29595,1267,GB,69,36,33,1,Team Random Map
2649484,"чё, хавать будешь?",29645,1266,RU,86,44,42,3,Team Random Map
2280390,Helium2268,29659,1266,NA,34,18,16,1,Team Random Map
2333411,Prot4gonist,29740,1265,DE,16,10,6,0,Team Random Map
2154801,tommy <3,29748,1265,DE,116,57,59,0,Team Random Map
218412,Phade,29771,1265,AT,101,52,49,1,Team Random Map
1561883,t.masson48,29773,1265,FR,60,28,32,4,Team Random Map
266192,dragggggggg,29789,1264,FR,74,39,35,0,Team Random Map
2364775,El Pirules,29813,1264,US,53,27,26,0,Team Random Map
2354979,Hsueyy,29815,1264,US,18,9,9,0,Team Random Map
1997049,Zepio,29839,1264,CA,25,14,11,0,Team Random Map
1829027,Björn IronSide,29845,1264,FR,44,21,23,2,Team Random Map
859021,ÖmerBeyDiyeceksiniz,29861,1263,TR,93,47,46,3,Team Random Map
792135,Pika Stark,29865,1263,CH,91,35,56,1,Team Random Map
2450589,mhaavaldsen,29894,1263,NO,19,11,8,1,Team Random Map
222717,Pointshot,29902,1263,DE,129,65,64,4,Team Random Map
1663468,tv/evilars,29923,1263,UA,12,8,4,0,Team Random Map
1374629,slavijo,29930,1263,US,162,79,83,1,Team Random Map
2706857,R'lyeh,29961,1262,PE,11,7,4,3,Team Random Map
2111495,aframundo167,29993,1262,AR,143,61,82,3,Team Random Map
2012897,Bazing Hood,29999,1262,ES,17,12,5,0,Team Random Map
1840365,FireFly,30009,1262,CH,90,44,46,0,Team Random Map
1065063,帝国老年人3,30027,1261,AR,29,13,16,2,Team Random Map
513046,clementixlegaullois,30045,1261,FR,16,6,10,1,Team Random Map
209330,Willbo_Baggins,30050,1261,IE,32,17,15,1,Team Random Map
1564520,Deku,30100,1261,FR,53,28,25,3,Team Random Map
311750,ElHombrePai,30101,1261,AR,158,66,92,5,Team Random Map
1326158,sebfs38,30109,1261,FR,45,26,19,0,Team Random Map
60593,yhcsurd,30125,1260,US,100,56,44,8,Team Random Map
647476,Bikinson,30132,1260,ES,165,73,92,5,Team Random Map
526957,Deep Fried Oreos,30136,1260,US,475,222,253,3,Team Random Map
2470786,DeReK!33,30147,1260,ES,40,23,17,0,Team Random Map
2250851,Fin,30153,1260,AT,46,24,22,1,Team Random Map
354034,noxi,30161,1260,AR,29,15,14,1,Team Random Map
2040049,elAmerican,30162,1260,BE,16,8,8,0,Team Random Map
2317289,Temmuz,30239,1259,TR,46,22,24,1,Team Random Map
2202053,Alko4689,30246,1259,NA,13,8,5,0,Team Random Map
2122574,Matz,30249,1259,CL,73,34,39,2,Team Random Map
222052,Timerio,30254,1259,AR,128,64,64,3,Team Random Map
1936001,guigui_3589,30262,1259,FR,64,33,31,0,Team Random Map
1247093,Shreaky,30277,1259,IN,83,38,45,4,Team Random Map
276422,Manifold,30279,1258,AR,17,11,6,0,Team Random Map
269199,BomberBallad,30281,1258,CA,23,13,10,0,Team Random Map
2629093,Sebag007,30300,1258,CL,21,10,11,1,Team Random Map
2454843,Tallaksen,30307,1258,NO,19,8,11,0,Team Random Map
2203591,raumpolizei,30317,1258,DE,14,9,5,0,Team Random Map
222297,da.ad,30323,1258,CH,171,82,89,4,Team Random Map
312401,haganmchenry,30340,1258,US,90,44,46,3,Team Random Map
1415152,bluemountain,30346,1258,TW,72,32,40,2,Team Random Map
294919,AllweneedisU,30348,1258,US,43,21,22,0,Team Random Map
1237580,NoHazard(Zae),30351,1258,FR,26,16,10,0,Team Random Map
2281650,sr juano,30404,1257,AR,14,9,5,0,Team Random Map
1992694,Fabien Barthez,30414,1257,ES,17,8,9,0,Team Random Map
5094,goooots,30439,1257,GB,42,23,19,0,Team Random Map
278888,Eh_chavo,30443,1256,PE,29,15,14,1,Team Random Map
259380,Geeeeeeorg,30446,1256,DE,16,8,8,1,Team Random Map
2535425,WannFanne,30466,1256,TR,11,6,5,0,Team Random Map
1775267,rossfrenett,30499,1256,GB,46,23,23,6,Team Random Map
1590810,Collossalthug,30506,1256,US,40,20,20,0,Team Random Map
217870,PREDATOR,30509,1256,FR,59,32,27,1,Team Random Map
1279521,Chambers,30512,1256,AU,18,9,9,0,Team Random Map
2353796,CHECO MAXIMUS,30546,1255,MX,36,16,20,1,Team Random Map
1939643,Pašteta,30570,1255,SI,78,39,39,7,Team Random Map
92929,Your Yamaraj,30580,1255,IN,23,14,9,0,Team Random Map
1442041,TOFEUR26,30586,1255,FR,123,53,70,6,Team Random Map
1207763,mixas,30594,1255,PE,125,60,65,7,Team Random Map
2701122,Polish Wonderboy,30625,1254,FR,12,9,3,0,Team Random Map
2276277,PKP76,30643,1254,FR,44,25,19,0,Team Random Map
937426,Blueage,30691,1253,AU,61,24,37,1,Team Random Map
903526,Nicolasbis,30694,1253,FR,71,42,29,0,Team Random Map
849949,[Sparta] BumsKunz,30695,1253,DE,211,99,112,1,Team Random Map
236750,Purkrabi,30705,1253,SK,39,25,14,2,Team Random Map
447477,digdig,30707,1253,DE,48,27,21,2,Team Random Map
2755361,Lord_Mastermind,30708,1253,PE,21,10,11,2,Team Random Map
2548094,Sir Jånnalot,30716,1253,NO,10,6,4,0,Team Random Map
2300189,fran__caballero,30724,1253,ES,26,12,14,0,Team Random Map
1987406,roduhame,30731,1253,FR,104,50,54,8,Team Random Map
270890,TDyk6,30754,1252,US,60,34,26,9,Team Random Map
579114,pierremews,30763,1252,FR,21,13,8,1,Team Random Map
2120694,SickPrince99827,30791,1252,NA,75,37,38,0,Team Random Map
1211077,Saymon,30821,1252,SI,18,7,11,1,Team Random Map
1146839,Drunk3n,30824,1251,DE,23,16,7,0,Team Random Map
1112439,Arianelko,30826,1251,SK,11,7,4,0,Team Random Map
627586,Kellek,30843,1251,DE,96,50,46,1,Team Random Map
2523895,Nomad,30855,1251,BR,23,13,10,0,Team Random Map
2507985,•RencaR• /Tom,30856,1251,AR,36,21,15,1,Team Random Map
2099225,Pilule,30878,1251,FR,24,14,10,3,Team Random Map
1892521,asaasa192,30886,1251,TW,115,56,59,2,Team Random Map
1687878,QuietProfesional,30892,1251,AU,47,27,20,2,Team Random Map
1072536,LiKEFede,30908,1250,AR,103,48,55,3,Team Random Map
1062674,Screwtape,30909,1250,US,128,62,66,2,Team Random Map
902367,Nikitus,30917,1250,AR,33,11,22,0,Team Random Map
890941,Deathwing,30918,1250,DE,227,94,133,4,Team Random Map
2570725,此间少年,30939,1250,CN,26,14,12,2,Team Random Map
396143,sergio_sg87,30940,1250,ES,44,23,21,1,Team Random Map
2391202,Mushroom,30948,1250,US,27,15,12,1,Team Random Map
2307895,L0rd3 G4b1t0,30953,1250,NA,64,32,32,4,Team Random Map
1871932,LeBoomJames,30971,1250,DE,13,8,5,0,Team Random Map
921458,DrJones,30992,1249,DE,136,67,69,2,Team Random Map
892565,GrapeNuttSoup,30994,1249,US,189,67,122,3,Team Random Map
574989,Marc Anton,31006,1249,DE,199,78,121,3,Team Random Map
2673299,Esposito,31016,1249,ES,13,9,4,0,Team Random Map
2138811,Копатыч,31040,1249,RU,40,21,19,1,Team Random Map
1151381,Aco,31065,1248,CA,28,16,12,1,Team Random Map
263644,cidovsky,31073,1248,BR,12,6,6,2,Team Random Map
2392153,Nalzu,31097,1248,FR,49,19,30,0,Team Random Map
1049839,ǷinꝽđunē41,31145,1247,GB,68,24,44,5,Team Random Map
2408979,Work Ethic,31167,1247,US,86,41,45,0,Team Random Map
2243387,Cafune,31175,1247,US,57,29,28,1,Team Random Map
1561598,Sylvain,31199,1247,FR,55,25,30,1,Team Random Map
1451958,o dawg,31203,1247,AU,71,34,37,2,Team Random Map
901032,The Serge,31220,1246,RO,43,23,20,0,Team Random Map
235974,mattiegamer,31232,1246,NL,48,24,24,1,Team Random Map
2517677,Monsieur Cosmik,31243,1246,FR,16,6,10,0,Team Random Map
2252900,Bukulak,31254,1246,CZ,62,38,24,0,Team Random Map
2099541,WolveDragon,31260,1246,NA,63,33,30,2,Team Random Map
219508,Blubbi,31275,1246,DE,52,31,21,2,Team Random Map
930052,frezx,31290,1245,DE,124,63,61,3,Team Random Map
748043,Mike_raft,31299,1245,GB,149,79,70,4,Team Random Map
634659,Quinta,31301,1245,IT,15,10,5,0,Team Random Map
2629647,SixtyNice,31311,1245,AU,66,33,33,3,Team Random Map
2307750,rensverschoor,31327,1245,NL,21,14,7,0,Team Random Map
2094290,sefakcaoglu,31335,1245,TR,118,57,61,5,Team Random Map
1790550,LeMelonChopper,31344,1245,US,48,27,21,0,Team Random Map
1776259,WARLORD,31345,1245,US,43,24,19,2,Team Random Map
1455482,Xender Cage,31358,1245,FR,65,33,32,6,Team Random Map
763830,jami0208,31377,1244,DE,85,28,57,1,Team Random Map
539455,Foley,31384,1244,DE,50,30,20,2,Team Random Map
2596331,BladedStream450,31394,1244,NA,30,15,15,2,Team Random Map
2515068,sledgehead,31397,1244,US,38,16,22,1,Team Random Map
2234191,Chefen,31411,1244,DK,52,25,27,3,Team Random Map
322166,单刷小飞侠,31429,1244,CN,66,29,37,4,Team Random Map
694556,Zagor Magnus,31465,1243,IT,313,131,182,17,Team Random Map
684614,pooplord,31467,1243,US,37,23,14,15,Team Random Map
1478393,BcrS,31523,1243,BR,123,60,63,7,Team Random Map
994519,Armaluz,31543,1242,CL,32,19,13,3,Team Random Map
939546,gilchivas,31547,1242,MX,50,28,22,0,Team Random Map
794681,StrikeMuffin,31554,1242,US,28,11,17,2,Team Random Map
2316153,ChrisLee1609,31581,1242,NA,259,117,142,27,Team Random Map
219966,Boaromir,31608,1242,DE,25,16,9,2,Team Random Map
312830,wojo2500,31611,1242,US,18,10,8,0,Team Random Map
214689,_Stevo_,31622,1241,AT,10,8,2,0,Team Random Map
2349867,Gyldran,31651,1241,FR,13,9,4,1,Team Random Map
2314288,^4[F.Y.N]^8EBR^8ONY,31654,1241,GR,89,43,46,1,Team Random Map
2232659,Hiltera,31657,1241,US,74,38,36,4,Team Random Map
2102965,eXecution,31663,1241,DE,21,10,11,1,Team Random Map
2027199,Emilien,31670,1241,FR,15,8,7,1,Team Random Map
1972590,bobo,31746,1240,FR,51,29,22,1,Team Random Map
1141095,Kiiwii,31768,1239,BE,41,25,16,0,Team Random Map
796637,AJAXMANNIEE,31775,1239,NL,63,32,31,1,Team Random Map
537467,TigerKing,31790,1239,DE,24,12,12,0,Team Random Map
362118,mc_the_ribber,31817,1239,DE,33,18,15,0,Team Random Map
2025163,david52,31821,1239,NL,125,59,66,1,Team Random Map
1865650,CatchingWalleye,31830,1239,NA,74,38,36,1,Team Random Map
1806876,Apathetical,31831,1239,TR,95,41,54,3,Team Random Map
1625999,Samurai Mikasa,31835,1239,MY,17,9,8,0,Team Random Map
1193103,NerzJongleur,31845,1239,AT,22,13,9,0,Team Random Map
2453401,DARK BIRDY ( Panpantmort),31875,1238,FR,61,28,33,2,Team Random Map
2347343,Riksbankschefen,31877,1238,SE,13,7,6,1,Team Random Map
2343540,啊浩,31878,1238,CN,10,3,7,1,Team Random Map
1877362,[Fruit] I'm a legal tho,31895,1238,US,23,14,9,1,Team Random Map
1338576,Horizon,31907,1238,NO,52,26,26,0,Team Random Map
1216165,StrangerWolf95,31912,1238,MX,39,12,27,2,Team Random Map
836229,Annicka Fr,31925,1237,FR,34,21,13,2,Team Random Map
2622851,anthonykrafft7,31938,1237,US,53,27,26,1,Team Random Map
1927740,TheMasterPitt,31970,1237,NA,10,4,6,2,Team Random Map
1914343,Azeyle,31971,1237,FR,148,70,78,1,Team Random Map
1455976,AdolfitoHilito,31980,1237,ES,146,62,84,3,Team Random Map
1108495,Titien62,31989,1236,FR,45,20,25,9,Team Random Map
247409,philipp9426,32000,1236,DE,38,21,17,1,Team Random Map
375126,mahmoodrm94,32028,1236,JO,303,123,180,11,Team Random Map
1933151,Meal,32044,1236,ES,60,31,29,0,Team Random Map
1807608,Maryjuanito,32050,1236,BR,19,10,9,0,Team Random Map
219889,Vanessa,32053,1236,CH,32,16,16,0,Team Random Map
313583,RocoDW,32058,1236,MX,22,12,10,0,Team Random Map
401537,aj.jr,32080,1235,MX,234,113,121,5,Team Random Map
2476685,elREYdelFLOW,32088,1235,CL,35,18,17,0,Team Random Map
2411252,Blueque,32093,1235,US,17,10,7,0,Team Random Map
2232751,Bread Pitt,32099,1235,IT,17,8,9,2,Team Random Map
2133417,segfaults9,32103,1235,CA,114,58,56,3,Team Random Map
624878,supahotfire,32138,1234,DE,23,11,12,1,Team Random Map
1559866,suansita,32180,1234,AU,31,12,19,3,Team Random Map
1395873,nutellamaniac,32185,1234,AU,270,106,164,12,Team Random Map
799291,Myrg,32206,1233,AU,51,28,23,1,Team Random Map
2401189,Pitinhas487,32230,1233,NA,37,21,16,1,Team Random Map
1014208,awnorus17,32287,1232,NA,79,40,39,2,Team Random Map
2449042,RayVaugan,32315,1232,AR,15,10,5,1,Team Random Map
368858,Valdegard,32326,1232,CH,224,118,106,9,Team Random Map
255980,Sand Brother,32365,1231,DK,15,6,9,0,Team Random Map
502132,Cuidabichis,32372,1231,MX,43,26,17,1,Team Random Map
2613261,MATIASBUSCALIA,32376,1231,AR,12,6,6,0,Team Random Map
2444134,Tachindo,32388,1231,NA,99,46,53,0,Team Random Map
224681,Sabbalot,32390,1231,DE,14,9,5,0,Team Random Map
197396,pantuzi,32395,1231,CH,13,8,5,1,Team Random Map
2269670,nAy gamdom.com,32397,1231,AR,43,20,23,1,Team Random Map
1640715,MergeVerts,32430,1231,NA,19,14,5,2,Team Random Map
1537524,FlightOfTheAlbatross,32434,1231,US,14,8,6,0,Team Random Map
1514059,Jalapeno Poppers.,32435,1231,TR,21,8,13,0,Team Random Map
703999,Lapsozin,32457,1230,BR,19,14,5,1,Team Random Map
2689158,TheTortillaMonster,32472,1230,US,12,7,5,0,Team Random Map
2012929,meugeniara,32494,1230,AR,12,9,3,0,Team Random Map
296287,white pony,32505,1230,DE,77,36,41,1,Team Random Map
837474,albertgregory1992,32516,1229,AU,174,63,111,8,Team Random Map
2693383,german_pepe89,32531,1229,AR,56,29,27,2,Team Random Map
2392018,KingKosovo,32542,1229,DE,50,28,22,6,Team Random Map
2066365,Dr. Dootdog,32553,1229,GB,16,10,6,1,Team Random Map
1857374,leshazelryx,32570,1229,FR,108,50,58,2,Team Random Map
1134266,MilouzZ_In the sky,32595,1228,FR,107,53,54,4,Team Random Map
1047355,AS1LZ4DE,32596,1228,TR,84,39,45,2,Team Random Map
272869,uNzaptediLeabLe,32602,1228,TR,35,17,18,0,Team Random Map
458822,Surreal,32615,1228,SE,91,45,46,1,Team Random Map
2659719,Pitoca,32619,1228,BR,46,23,23,2,Team Random Map
2460136,Dieter Kleber,32624,1228,CH,19,7,12,0,Team Random Map
1466992,chern,32657,1228,AR,55,26,29,2,Team Random Map
1302703,Folberg,32729,1227,NA,35,17,18,0,Team Random Map
1014752,Heretik Live,32736,1226,NA,84,37,47,2,Team Random Map
659302,Tabanera,32746,1226,ES,17,9,8,0,Team Random Map
225605,Co2p,32760,1226,SE,11,4,7,1,Team Random Map
2348608,bt1014,32769,1226,US,203,95,108,1,Team Random Map
2317458,König Klöti,32770,1226,DE,170,84,86,19,Team Random Map
471756,Capitalist Dog,32818,1225,US,11,8,3,0,Team Random Map
2353770,Pepe,32840,1225,AR,28,18,10,1,Team Random Map
896402,breum,32872,1224,RE,121,49,72,3,Team Random Map
442924,TinyTonk52,32892,1224,AU,23,16,7,1,Team Random Map
2646971,DarthGandalf,32894,1224,NL,12,6,6,2,Team Random Map
2413956,Geile Giraffe,32898,1224,DE,158,82,76,9,Team Random Map
2347978,Nazzgarrr,32901,1224,NA,90,46,44,3,Team Random Map
2096361,Dokkal,32907,1224,FR,17,13,4,0,Team Random Map
1997554,Rockyzz,32912,1224,AR,18,10,8,0,Team Random Map
2635905,Plantaránpatatas,32954,1223,ES,35,20,15,0,Team Random Map
2380125,Sentrix,32968,1223,GB,21,8,13,0,Team Random Map
2104155,WIZBIZNUZZZ,32979,1223,TR,68,30,38,3,Team Random Map
2078024,ThomsonT,32982,1223,NL,10,8,2,0,Team Random Map
1729479,Asada Shino,32992,1223,TR,45,19,26,3,Team Random Map
1541007,Roger,33002,1223,BR,15,8,7,0,Team Random Map
1014102,shadow_aspect91,33024,1222,GB,14,10,4,0,Team Random Map
901563,Tapsin,33028,1222,CL,50,24,26,2,Team Random Map
240421,100Hz,33111,1221,CH,33,13,20,2,Team Random Map
2584045,nacho.r.10,33123,1221,AR,49,26,23,0,Team Random Map
2452380,liammuenchhoff,33129,1221,DE,42,16,26,0,Team Random Map
2221487,MarcusBBCarryYou,33136,1221,HK,17,10,7,0,Team Random Map
2083229,Ðrêsslêr18,33147,1221,AT,44,21,23,1,Team Random Map
753612,emarz4697,33188,1220,AU,12,8,4,1,Team Random Map
1942530,p3ibol,33221,1220,ES,19,10,9,1,Team Random Map
1713321,Gull,33228,1220,SE,58,32,26,0,Team Random Map
1503752,Lord 0f Lemons,33231,1220,NZ,15,9,6,1,Team Random Map
1248824,noe.malais,33236,1220,FR,48,25,23,5,Team Random Map
2611379,ES,33257,1219,AR,12,8,4,1,Team Random Map
387050,The Anarchist,33265,1219,AU,113,48,65,2,Team Random Map
2203390,Magma-TN,33279,1219,TN,64,31,33,1,Team Random Map
2128028,nihilean,33286,1219,DE,32,17,15,0,Team Random Map
1872310,jimmy.35,33299,1219,FR,37,19,18,3,Team Random Map
386741,je-reve-souvent,33345,1218,FR,276,115,161,7,Team Random Map
2004509,Apex,33367,1218,US,102,53,49,6,Team Random Map
345547,The A-Factor,33370,1218,AU,16,10,6,1,Team Random Map
2256349,eSacaluTati,33430,1217,RO,128,64,64,0,Team Random Map
651518,StopSayingShubek,33466,1216,AU,10,5,5,0,Team Random Map
2608388,gonza,33478,1216,AR,22,11,11,0,Team Random Map
2407904,Chaplin,33486,1216,CA,37,22,15,1,Team Random Map
904853,jake.mckean4,33530,1215,US,10,4,6,0,Team Random Map
250274,AtomicMuffin,33534,1215,IT,181,76,105,15,Team Random Map
584909,Santapaprika,33537,1215,CA,27,14,13,0,Team Random Map
2174318,Boddah,33571,1215,CZ,19,11,8,0,Team Random Map
2152239,hulo,33574,1215,DE,48,24,24,0,Team Random Map
2051910,Geronimo,33580,1215,CH,26,10,16,1,Team Random Map
1941463,aniri_west,33586,1215,DE,14,6,8,0,Team Random Map
1930971,Plaque des goûts,33587,1215,FR,52,25,27,0,Team Random Map
1271400,regenbogenbronson,33603,1215,DE,68,32,36,8,Team Random Map
211898,MCEpsYloN,33619,1214,CH,68,29,39,9,Team Random Map
2496729,iRRe&b,33633,1214,FR,32,17,15,1,Team Random Map
2382373,SaDc,33640,1214,CO,21,13,8,1,Team Random Map
368264,Seraphim,33647,1214,TR,18,10,8,0,Team Random Map
1860446,Conka,33661,1214,TR,21,12,9,1,Team Random Map
214728,Swelinkan,33678,1213,SE,95,33,62,3,Team Random Map
279955,krayt5,33679,1213,IT,30,17,13,0,Team Random Map
1057073,Trianox,33680,1213,CA,295,132,163,3,Team Random Map
960120,Mallus Popallus,33683,1213,DE,39,21,18,1,Team Random Map
2358808,WalterNelson-,33716,1213,AR,18,10,8,0,Team Random Map
1691722,Henne,33745,1213,DE,14,9,5,1,Team Random Map
1428793,Kanzaki,33751,1213,CA,48,22,26,2,Team Random Map
2591434,Ch_Kurt,33772,1212,DE,19,12,7,0,Team Random Map
2445237,Dicarto,33777,1212,FR,26,14,12,0,Team Random Map
2301633,Mackpein,33788,1212,IT,53,25,28,0,Team Random Map
2286659,Kongbu,33790,1212,FR,57,26,31,4,Team Random Map
2270406,guidofacce,33793,1212,UY,11,8,3,3,Team Random Map
2219065,petersmithofasu,33796,1212,US,106,52,54,2,Team Random Map
1991584,eeph,33804,1212,DE,14,6,8,1,Team Random Map
1908968,ppL™,33809,1212,DE,169,81,88,4,Team Random Map
1115948,Nik,33832,1211,DE,163,78,85,3,Team Random Map
389249,DerPanzermensch,33855,1211,AR,79,41,38,2,Team Random Map
2466443,byram,33856,1211,TR,83,43,40,8,Team Random Map
2091849,lambinamtor,33865,1211,NZ,31,16,15,0,Team Random Map
1946790,lawliet;,33874,1211,AR,33,18,15,0,Team Random Map
827387,HopesPokes,33910,1210,DE,68,36,32,3,Team Random Map
1500590,chieh0804,33954,1210,TW,17,9,8,0,Team Random Map
939873,Danielxu422,33965,1209,JP,12,9,3,0,Team Random Map
246902,VariableBull320,33973,1209,NA,45,26,19,1,Team Random Map
404464,Boarslayer,33983,1209,AU,16,8,8,1,Team Random Map
2540432,BarnsM&M's,33987,1209,FR,108,53,55,1,Team Random Map
2315056,Tuxtron,33993,1209,ES,12,6,6,0,Team Random Map
222913,[FaZe] Frock!?,33997,1209,NL,15,10,5,2,Team Random Map
1980477,Julpe,34007,1209,CO,22,9,13,0,Team Random Map
1927972,Rufus,34008,1209,DE,69,35,34,0,Team Random Map
1844499,Filipusis92,34013,1209,NA,15,10,5,0,Team Random Map
1134823,Almogàver,34035,1208,ES,90,42,48,4,Team Random Map
693486,Hanko,34049,1208,ES,10,7,3,0,Team Random Map
2506576,Ultrasasa,34071,1208,AU,18,11,7,0,Team Random Map
1774267,TuxThib,34100,1208,NA,12,5,7,0,Team Random Map
1495665,DEUS VULT,34106,1208,GB,63,34,29,0,Team Random Map
1136483,Adley,34113,1207,FR,15,8,7,0,Team Random Map
873146,hayashireii,34122,1207,TW,19,10,9,2,Team Random Map
383248,rudeaugusto,34142,1207,PE,327,157,170,21,Team Random Map
2327303,Ravijoshua,34147,1207,NA,159,70,89,10,Team Random Map
368030,Lepouras,34151,1207,GR,215,99,116,5,Team Random Map
480157,Mr_Lepe,34185,1206,CL,36,17,19,0,Team Random Map
1937461,Roi Nou,34218,1206,FR,21,8,13,0,Team Random Map
1619492,rhajah,34222,1206,US,140,65,75,1,Team Random Map
1586197,Castermaluney,34224,1206,IT,10,5,5,0,Team Random Map
1422378,MrFougere (CooperTV),34227,1206,FR,76,40,36,0,Team Random Map
1347888,Mixure,34234,1206,FR,76,38,38,1,Team Random Map
772824,Crazy Dux,34246,1205,BE,10,7,3,0,Team Random Map
2480189,theRealSlimShady,34265,1205,US,56,28,28,0,Team Random Map
1630564,Coryl o' Neile,34300,1205,IT,97,39,58,11,Team Random Map
1543810,shieh,34305,1205,CN,38,15,23,11,Team Random Map
1969071,GamseZ,34359,1204,BE,16,9,7,0,Team Random Map
335472,Delphi,34369,1204,DE,14,9,5,0,Team Random Map
1489817,Your Best Nightmare,34377,1204,AU,100,38,62,1,Team Random Map
1159965,southernrenegade916,34389,1203,US,55,26,29,2,Team Random Map
2520838,JeCuMu,34421,1203,ES,74,38,36,3,Team Random Map
2025661,robert9483,34443,1203,NA,30,12,18,2,Team Random Map
2025550,Dottore,34444,1203,DE,35,20,15,1,Team Random Map
1894836,EmnuZ,34455,1203,IT,25,13,12,1,Team Random Map
299378,LudwigVon401,34467,1203,US,68,34,34,0,Team Random Map
2175934,Lord Sacramento,34512,1202,GB,86,42,44,5,Team Random Map
1881728,Uncle Rico,34525,1202,US,19,10,9,0,Team Random Map
1425729,MissBioHazards,34541,1202,CA,180,68,112,2,Team Random Map
1150319,RedSk0rpi0,34554,1201,CO,30,17,13,0,Team Random Map
214861,freshwholemilk,34556,1201,DE,61,31,30,3,Team Random Map
611618,Tomi,34572,1201,AR,73,38,35,0,Team Random Map
2105346,rpetice,34602,1201,HU,66,34,32,1,Team Random Map
1981581,Veliuswiegraf,34610,1201,NA,66,29,37,7,Team Random Map
1829389,KleeSchnee,34613,1201,NA,57,28,29,3,Team Random Map
333080,Kaon,34614,1201,DE,92,44,48,6,Team Random Map
861763,A.SkywalkeR,34624,1200,ES,39,21,18,0,Team Random Map
718342,Trinx.exe,34628,1200,DE,20,10,10,0,Team Random Map
501920,Morzan,34632,1200,DE,21,12,9,0,Team Random Map
2537009,Josfhat,34640,1200,CA,73,38,35,1,Team Random Map
1565390,HONK PEPE :o),34677,1200,IT,75,31,44,0,Team Random Map
2419472,Cemalamca,34713,1199,TR,62,33,29,3,Team Random Map
2132585,matrikar,34734,1199,RU,64,33,31,1,Team Random Map
2010082,BimBaChe,34742,1199,ES,18,9,9,1,Team Random Map
1807405,Wilski,34754,1199,NO,22,13,9,3,Team Random Map
1979880,priecan,34822,1198,ES,42,18,24,0,Team Random Map
1617033,Sallow,34835,1198,FR,39,23,16,4,Team Random Map
1304918,benedikt121212,34846,1198,DE,20,11,9,1,Team Random Map
768437,gaetan789,34863,1197,FR,32,16,16,2,Team Random Map
548815,stefan17,34869,1197,DE,81,45,36,4,Team Random Map
1972001,Vipercavy,34904,1197,US,11,8,3,0,Team Random Map
1762753,alexpolu,34913,1197,GR,129,55,74,5,Team Random Map
1109109,Ergonom,34931,1196,FI,31,15,16,2,Team Random Map
2114868,lukedls,34968,1196,GB,53,24,29,3,Team Random Map
2080179,xetesk,34970,1196,FR,25,14,11,1,Team Random Map
2010094,Rico El Loco,34972,1196,FR,162,68,94,7,Team Random Map
1349184,ertanevrim,34991,1196,TR,88,41,47,1,Team Random Map
758931,Mr_Underhill,35004,1195,US,18,9,9,0,Team Random Map
2649946,Nanman,35017,1195,US,36,20,16,1,Team Random Map
2193254,L'Orso di Civezzano,35039,1195,IT,45,22,23,1,Team Random Map
1711315,Yen House,35060,1195,TW,27,10,17,0,Team Random Map
1679749,a.noriegap88,35061,1195,PE,19,10,9,0,Team Random Map
314915,Kasara,35064,1195,US,73,37,36,0,Team Random Map
1393181,THE CUSQUEÑO OF GOLD,35070,1195,PE,44,21,23,18,Team Random Map
1353773,helispin,35073,1195,AU,40,21,19,1,Team Random Map
724489,WasaCDLP,35087,1194,CL,39,21,18,5,Team Random Map
661880,Miasma,35091,1194,FI,74,32,42,2,Team Random Map
2543230,lucasmarc,35105,1194,GB,49,23,26,0,Team Random Map
2134282,TheMadDogXP,35122,1194,NZ,38,19,19,1,Team Random Map
1946560,Joker0848111,35132,1194,NA,206,81,125,4,Team Random Map
1282116,yopkool,35150,1194,FR,180,85,95,7,Team Random Map
2297663,jp3013,35182,1193,US,24,13,11,0,Team Random Map
2018089,Rehf Dogg,35198,1193,US,129,61,68,4,Team Random Map
1291878,Hero,35219,1193,US,150,61,89,5,Team Random Map
2480124,SI TOCA NÓMADA DODGEO,35260,1192,AR,32,15,17,0,Team Random Map
2470862,Alfa,35261,1192,TR,74,40,34,7,Team Random Map
2467935,big_cheese_69,35262,1192,CA,23,14,9,0,Team Random Map
2155751,Lucho Jara,35274,1192,CL,18,10,8,0,Team Random Map
2497844,Kikurage,35347,1191,DE,10,6,4,1,Team Random Map
2445114,RocketCat,35349,1191,IS,21,13,8,0,Team Random Map
2183511,AlloY,35362,1191,US,36,20,16,2,Team Random Map
2023993,XxCoMmBuNkErxX,35369,1191,NA,263,110,153,22,Team Random Map
2001850,MunroWarrior,35370,1191,AR,40,22,18,3,Team Random Map
1923766,fjCAMO,35378,1191,MX,159,71,88,1,Team Random Map
1896471,JackOfBlades,35380,1191,CH,51,30,21,1,Team Random Map
1122715,goku.exe,35403,1190,IN,103,47,56,10,Team Random Map
615845,Del-Rayfor,35415,1190,US,26,12,14,2,Team Random Map
535866,chalker,35418,1190,BR,39,21,18,3,Team Random Map
2537245,king0ld,35432,1190,DO,15,7,8,3,Team Random Map
2410719,Chicken Bo,35440,1190,US,18,10,8,0,Team Random Map
2332160,Vilm360,35442,1190,NA,24,13,11,3,Team Random Map
2278865,thoscar4,35447,1190,FR,145,67,78,0,Team Random Map
2252529,Azazel,35449,1190,IN,26,12,14,0,Team Random Map
705142,noetic le_guerier,35495,1189,CH,78,47,31,1,Team Random Map
2474207,FrostFurry,35521,1189,LV,33,18,15,0,Team Random Map
1879226,BolzanoWeierstrass,35549,1189,FR,32,19,13,1,Team Random Map
1847779,Mamelouk,35551,1189,FR,27,13,14,0,Team Random Map
1742774,SeGomismo,35554,1189,NA,38,19,19,1,Team Random Map
2760574,LazeR,35574,1188,NO,18,10,8,1,Team Random Map
2736116,Stanley,35575,1188,US,12,6,6,0,Team Random Map
1817804,Pu$$y T00 H0t,35613,1188,AU,19,11,8,0,Team Random Map
1711498,juanito,35617,1188,FR,74,32,42,0,Team Random Map
746855,Hortifruty,35645,1187,ES,60,29,31,1,Team Random Map
2409526,Necro,35659,1187,AR,36,17,19,5,Team Random Map
2305828,gamdan89,35665,1187,NL,53,20,33,4,Team Random Map
1926761,Excalibur,35681,1187,HK,23,11,12,0,Team Random Map
1736433,Hagrid0711,35687,1187,DE,191,82,109,6,Team Random Map
2060301,Xoric,35743,1186,ES,150,63,87,0,Team Random Map
1975903,alealdo,35748,1186,AR,17,8,9,1,Team Random Map
1554107,PacoDaLucia,35765,1186,NL,13,8,5,0,Team Random Map
525407,flopsh0t,35796,1185,US,564,243,321,10,Team Random Map
474214,Lord Thanos,35798,1185,US,270,120,150,26,Team Random Map
227768,Sr. Zombra,35799,1185,CO,20,11,9,0,Team Random Map
408847,Ranger,35801,1185,US,30,14,16,0,Team Random Map
2576220,UglyMagician,35806,1185,TR,67,35,32,5,Team Random Map
2361550,El Burrito,35810,1185,AR,75,35,40,3,Team Random Map
2311372,cakes,35814,1185,AU,34,17,17,1,Team Random Map
366168,CHASTMAN,35818,1185,ES,98,31,67,3,Team Random Map
2127698,Pepe Kakemann,35821,1185,DE,59,29,30,0,Team Random Map
1919852,Lenno,35835,1185,DE,53,27,26,0,Team Random Map
1882219,AllStar,35836,1185,DE,25,13,12,1,Team Random Map
1357679,FriedrichOttoSchmidt,35851,1185,RU,111,47,64,8,Team Random Map
533802,豬頭我的車咧!?,35874,1184,TW,101,49,52,7,Team Random Map
416315,Wall all lol  30,35880,1184,PE,32,16,16,8,Team Random Map
2230020,Deathburn,35896,1184,DE,40,19,21,0,Team Random Map
2224127,KingLouis_,35898,1184,DE,40,19,21,0,Team Random Map
2143888,WololoMaker,35900,1184,BR,22,10,12,1,Team Random Map
1587840,Dübeldoldi,35925,1184,DE,34,12,22,0,Team Random Map
1151605,gerniator,35931,1183,AT,42,21,21,2,Team Random Map
242166,Schoffrey,35943,1183,DE,55,27,28,0,Team Random Map
2462533,devrimsoysal2,35957,1183,TR,51,27,24,2,Team Random Map
1510698,Kubicek,35993,1183,CZ,71,34,37,2,Team Random Map
1517989,Stan444,35996,1183,FR,54,29,25,1,Team Random Map
1485462,Cliffteezy,35997,1183,US,12,6,6,0,Team Random Map
300893,RRV,36004,1183,US,33,15,18,1,Team Random Map
1262599,or.llanos,36009,1183,MX,43,24,19,0,Team Random Map
943767,madHatter,36019,1182,NO,28,15,13,0,Team Random Map
410565,Crazy Penguin,36031,1182,AU,64,29,35,1,Team Random Map
2615501,Tulcas,36035,1182,AT,16,9,7,2,Team Random Map
2500392,Asyd,36038,1182,US,17,10,7,0,Team Random Map
2313242,LOL Champion,36044,1182,CZ,67,33,34,0,Team Random Map
2299223,achallans,36046,1182,GB,15,7,8,1,Team Random Map
2242338,ADESu,36049,1182,ES,77,31,46,0,Team Random Map
1886008,terencil,36072,1182,CH,14,9,5,3,Team Random Map
1186643,BlitzZerg,36088,1182,ES,16,11,5,0,Team Random Map
1043297,[KSK] Stener™,36093,1181,DE,47,26,21,2,Team Random Map
2587470,Koxinho,36110,1181,FR,16,9,7,0,Team Random Map
380175,tb2r,36115,1181,FR,218,102,116,19,Team Random Map
2320296,RacsoRules,36120,1181,MX,15,7,8,0,Team Random Map
300207,El Fuerto Sabio,36150,1181,US,177,67,110,8,Team Random Map
269589,Rickos,36166,1180,FR,105,43,62,4,Team Random Map
516556,hitman_fucsia,36185,1180,PE,29,16,13,3,Team Random Map
469916,vingiaime,36187,1180,IT,55,24,31,1,Team Random Map
440832,wYzant,36191,1180,US,20,10,10,3,Team Random Map
1969580,Mad Max,36216,1180,AT,65,27,38,0,Team Random Map
1951480,Howling_Mad,36218,1180,AT,31,14,17,4,Team Random Map
1880182,saturas,36223,1180,CH,18,11,7,0,Team Random Map
1718690,EH-EH-RON,36228,1180,US,89,41,48,14,Team Random Map
2493555,Cédric le Bon,36264,1179,FR,82,43,39,2,Team Random Map
2406317,Thortuga,36270,1179,PT,65,29,36,0,Team Random Map
2277947,Vincent1n,36276,1179,GB,44,18,26,0,Team Random Map
1939885,GG,36297,1179,IL,37,18,19,1,Team Random Map
1415955,TuBeers,36315,1179,DE,21,11,10,1,Team Random Map
1033948,fontana.federico1991,36322,1178,GB,63,34,29,3,Team Random Map
2428826,cifuman,36356,1178,CO,26,10,16,3,Team Random Map
471575,2873414537,36419,1177,CN,235,73,162,54,Team Random Map
2534893,parcero9576,36424,1177,NA,42,23,19,1,Team Random Map
2530849,Paroksha,36425,1177,NA,46,20,26,9,Team Random Map
2399413,TuNaXi,36429,1177,TR,25,11,14,0,Team Random Map
2317798,masatoshi.ono,36433,1177,JP,64,29,35,1,Team Random Map
353976,Blois,36445,1177,IT,26,15,11,0,Team Random Map
840312,Weird Suport,36471,1176,US,104,51,53,1,Team Random Map
199690,BodokoS,36473,1176,NA,56,23,33,4,Team Random Map
584027,Sekuro,36476,1176,DE,50,28,22,4,Team Random Map
2114777,Suanagan,36502,1176,ES,41,18,23,4,Team Random Map
1959218,kodzh,36512,1176,GB,14,7,7,0,Team Random Map
1555692,MCanzy,36525,1176,TR,43,26,17,6,Team Random Map
1517447,Duque de Alba,36526,1176,AR,29,16,13,1,Team Random Map
1510230,heduh5,36527,1176,CH,40,13,27,4,Team Random Map
2325391,The Garcier IV Maximus,36568,1175,ES,61,28,33,5,Team Random Map
2260413,jejune,36572,1175,US,10,7,3,0,Team Random Map
1722411,Yaek,36597,1175,DE,14,5,9,0,Team Random Map
1075206,k_cho46,36602,1174,MX,41,24,17,0,Team Random Map
1462317,ScorpSnake,36669,1174,NA,42,21,21,2,Team Random Map
782391,javi123321,36685,1173,PE,30,14,16,2,Team Random Map
650366,LUCHOPAY12,36692,1173,NA,36,19,17,0,Team Random Map
2531664,010santigomez,36699,1173,AR,21,13,8,1,Team Random Map
2519558,OG | shreyash,36700,1173,IN,56,27,29,6,Team Random Map
2312145,RainNB,36709,1173,CL,23,11,12,1,Team Random Map
2244803,=(e)= Marcoboy24 |153,36711,1173,NL,40,17,23,1,Team Random Map
1614571,Toski,36728,1173,BR,50,22,28,6,Team Random Map
313351,PHOINIX,36731,1173,AR,72,33,39,7,Team Random Map
1446391,LupusLobo,36734,1173,AR,152,66,86,5,Team Random Map
295841,Randaal,36736,1173,CL,23,11,12,2,Team Random Map
1222289,Knallgas M.A.,36740,1173,DE,59,28,31,1,Team Random Map
432220,"Raymond, Prince of Antioch",36762,1172,AU,215,86,129,10,Team Random Map
2681961,Pap's,36766,1172,CL,29,14,15,3,Team Random Map
2349135,lage_r,36775,1172,SE,10,5,5,0,Team Random Map
289232,bugout,36829,1172,CA,109,48,61,5,Team Random Map
2481092,GMURO,36854,1171,MX,13,7,6,0,Team Random Map
2581400,Janus,36925,1170,FR,23,12,11,1,Team Random Map
2288799,ollismrg,36940,1170,GB,38,18,20,2,Team Random Map
1741844,Crewstian,36971,1170,SE,54,24,30,0,Team Random Map
1668546,TH41 Big Slick Rick,36973,1170,US,16,10,6,0,Team Random Map
396609,Critdown,37016,1169,DE,42,18,24,0,Team Random Map
2155295,Vivi,37031,1169,IN,21,12,9,2,Team Random Map
1869063,alessandro.diroberto,37046,1169,AE,137,61,76,3,Team Random Map
1740850,hogergo,37048,1169,HU,35,20,15,0,Team Random Map
268567,pjdrose,37074,1168,PT,276,130,146,13,Team Random Map
2257669,Nicomolinagnr,37115,1168,AR,79,33,46,4,Team Random Map
2146369,feparadac,37120,1168,CL,74,34,40,9,Team Random Map
1920342,RossdorferJung,37137,1168,CH,48,22,26,0,Team Random Map
1834215,PraZZenD,37141,1168,NL,22,12,10,1,Team Random Map
1437358,Censach,37152,1168,RU,106,47,59,10,Team Random Map
262417,GlennHysen,37174,1167,SE,94,42,52,9,Team Random Map
674988,Wireless ऊदबिलाव,37176,1167,IN,125,61,64,13,Team Random Map
2729861,Jason Bourne,37188,1167,ES,11,5,6,0,Team Random Map
2386091,Schnappi0815,37196,1167,DE,71,36,35,2,Team Random Map
1918009,Dinde_de_Choix,37217,1167,FR,21,12,9,0,Team Random Map
1459452,hi im george,37232,1167,HK,126,58,68,4,Team Random Map
1166291,shadow-hunter76,37244,1166,FR,286,132,154,5,Team Random Map
2657545,Pvt. Capo Adrien,37261,1166,FR,10,7,3,0,Team Random Map
2581876,Derzeon,37263,1166,CO,15,10,5,0,Team Random Map
2291371,OldTxakurnaut,37276,1166,NA,133,45,88,7,Team Random Map
2108358,thomp951,37282,1166,FR,99,44,55,0,Team Random Map
2048195,Le Daf,37290,1166,FR,20,11,9,0,Team Random Map
219991,Korez,37302,1166,FI,36,20,16,0,Team Random Map
1551220,Shòt,37306,1166,FR,17,10,7,0,Team Random Map
787267,Beefallo,37324,1165,IN,67,32,35,1,Team Random Map
647282,vinisilva06,37326,1165,US,17,7,10,1,Team Random Map
434582,Johnny courtecouille,37332,1165,FR,37,17,20,0,Team Random Map
2400708,ChaudSept,37343,1165,FR,33,19,14,1,Team Random Map
2290217,BOO-CHAN,37352,1165,ES,35,20,15,1,Team Random Map
1580193,Mrgg,37376,1165,FR,45,20,25,2,Team Random Map
1026082,the phells,37387,1164,NA,64,27,37,10,Team Random Map
1003098,Scheppie,37389,1164,NL,18,10,8,1,Team Random Map
236393,fesakul,37404,1164,DE,77,43,34,3,Team Random Map
2547812,Mongo,37411,1164,GB,39,23,16,7,Team Random Map
2293019,SchellnSau,37424,1164,DE,14,3,11,1,Team Random Map
1212411,Welleeeeh,37454,1164,CO,98,49,49,3,Team Random Map
1721274,Atarius,37510,1163,GB,10,7,3,0,Team Random Map
302128,TheShawThing,37516,1163,AU,18,8,10,3,Team Random Map
1030530,yoyomannyoyo,37521,1162,TW,26,14,12,1,Team Random Map
2066279,KromerLomer,37566,1162,CL,17,9,8,0,Team Random Map
2025960,Jose de San Martin,37568,1162,AR,26,7,19,1,Team Random Map
1686028,WizKeyAndCoffee,37580,1162,DE,68,39,29,3,Team Random Map
1600111,feticalol,37585,1162,BE,36,19,17,0,Team Random Map
504628,niczbinden,37615,1161,FR,29,16,13,0,Team Random Map
1941012,spilling,37646,1161,GB,52,26,26,0,Team Random Map
1931798,Mr_Yao,37647,1161,ES,21,11,10,1,Team Random Map
642185,h☢ppy-☭six-bullets☭,37666,1160,ES,140,54,86,3,Team Random Map
233193,T12uth_,37669,1160,US,68,32,36,9,Team Random Map
416961,bluebird,37672,1160,US,17,8,9,1,Team Random Map
1980080,Aozeny,37701,1160,FR,50,23,27,2,Team Random Map
1390392,skynetcrln,37724,1160,TR,12,7,5,0,Team Random Map
1328196,KingoftheRunts,37728,1160,GB,68,22,46,7,Team Random Map
1206764,Blackened,37731,1160,US,12,8,4,0,Team Random Map
1534798,HeroinHero,37793,1159,DE,32,10,22,1,Team Random Map
1356149,Sierra Oscar,37796,1159,IE,31,12,19,1,Team Random Map
1111302,BOBARIUS3153,37798,1159,NA,40,21,19,2,Team Random Map
1073335,ilikeslicebread,37800,1158,BH,210,89,121,26,Team Random Map
2610034,tomas23ruslender,37822,1158,AR,80,43,37,3,Team Random Map
364815,ieauda,37839,1158,FR,23,10,13,1,Team Random Map
2153797,Zenavi,37840,1158,FR,25,13,12,0,Team Random Map
2092360,LowBatt,37843,1158,AR,12,6,6,0,Team Random Map
196593,Hao_Arg,37874,1157,AR,12,6,6,1,Team Random Map
611839,Tote,37881,1157,UY,32,12,20,0,Team Random Map
407405,krecwark,37889,1157,US,15,8,7,0,Team Random Map
2438083,Mütemerrit,37909,1157,TR,132,58,74,10,Team Random Map
2388529,klad,37911,1157,GB,54,31,23,1,Team Random Map
2056672,DiAngeli90,37925,1157,BR,96,42,54,2,Team Random Map
2052946,gianlucamarch2007,37926,1157,AR,23,12,11,0,Team Random Map
1908924,Pardaillec,37938,1157,FR,45,21,24,0,Team Random Map
244723,GTR73,37961,1156,FR,80,38,42,2,Team Random Map
2715084,maurinho26,37966,1156,IT,11,6,5,0,Team Random Map
2291748,Leonardo,37981,1156,DE,10,6,4,0,Team Random Map
894768,SGS,38016,1155,IN,67,23,44,16,Team Random Map
2697045,device,38028,1155,RU,12,7,5,0,Team Random Map
2594733,BOT why,38033,1155,DK,11,7,4,0,Team Random Map
2094471,Pooclak,38056,1155,CA,23,11,12,1,Team Random Map
1995149,josesanbol,38060,1155,ES,21,6,15,0,Team Random Map
903400,TheRevenant90,38091,1154,DE,140,70,70,5,Team Random Map
688734,TheRapiner,38098,1154,FR,29,15,14,0,Team Random Map
2432014,CaptainPlanet,38117,1154,NZ,40,20,20,1,Team Random Map
2426592,Worstmetvla,38118,1154,NL,28,14,14,0,Team Random Map
2443375,frodogann,38175,1153,FR,21,12,9,1,Team Random Map
2373750,Xerxes,38177,1153,CA,59,31,28,0,Team Random Map
2216704,Adaloth,38184,1153,AR,16,10,6,0,Team Random Map
2031982,mdecelle,38192,1153,US,105,50,55,1,Team Random Map
1667378,디에고는 당신을 거시기,38200,1153,AR,26,15,11,2,Team Random Map
1258604,SoJi,38212,1153,FR,43,22,21,1,Team Random Map
1245838,Kernarbeiter,38213,1153,DE,50,15,35,1,Team Random Map
546058,Bagger,38227,1152,DE,87,41,46,13,Team Random Map
2715763,ASKİNAESKİYA,38230,1152,TR,34,17,17,0,Team Random Map
2402341,pommepoco44,38241,1152,FR,11,7,4,0,Team Random Map
2188243,Talock,38250,1152,US,96,37,59,0,Team Random Map
1933371,Runaway Turtle,38262,1152,US,24,13,11,1,Team Random Map
1865510,ANDREY,38268,1152,BR,78,38,40,3,Team Random Map
1719837,DrPressure88,38273,1152,AT,55,23,32,0,Team Random Map
860142,divigt,38288,1151,ES,263,121,142,16,Team Random Map
2351892,alexneosg,38310,1151,ES,144,63,81,4,Team Random Map
2246744,JeremiasJero,38313,1151,AR,14,8,6,1,Team Random Map
1851060,danyisokay,38329,1151,IN,29,10,19,0,Team Random Map
1736931,FlipSide,38334,1151,US,18,9,9,0,Team Random Map
632080,MARDINLI SERSERI,38357,1150,TR,182,75,107,2,Team Random Map
170561,Backlund,38359,1150,SE,38,19,19,0,Team Random Map
1955776,damarc,38395,1150,AR,45,24,21,4,Team Random Map
1515846,CreepiestSnow32,38409,1150,NA,16,8,8,0,Team Random Map
1024651,Loconandi,38423,1149,CL,32,17,15,2,Team Random Map
2268747,Richie Iannucci,38462,1149,DE,56,30,26,2,Team Random Map
2161087,Canooski,38466,1149,US,40,20,20,0,Team Random Map
2122400,itachigo74ma,38471,1149,FR,114,54,60,0,Team Random Map
2043573,LukeKingsen,38477,1149,DE,76,36,40,1,Team Random Map
1884340,Miguelitolón,38499,1149,ES,67,29,38,1,Team Random Map
1402147,Tsla420yoloswaghetti,38511,1149,CH,13,9,4,0,Team Random Map
214804,Orri - Snow Killer,38518,1148,FR,19,12,7,1,Team Random Map
1630949,CoyBlackout95,38568,1148,AU,205,68,137,7,Team Random Map
1969026,-nl- Henkie,38625,1147,NL,18,6,12,0,Team Random Map
1861037,Gabbar,38629,1147,NL,15,7,8,0,Team Random Map
1850822,pedrolito7,38631,1147,FR,25,12,13,0,Team Random Map
1397753,Nonnaldo,38641,1147,DE,97,41,56,5,Team Random Map
1049551,CHAMPI-ATOMIK,38650,1146,FR,41,23,18,0,Team Random Map
770496,WattledFerret53,38656,1146,NA,32,15,17,4,Team Random Map
2683723,Pipemaster28,38664,1146,CO,15,6,9,2,Team Random Map
1956951,Jean Pierre Foucault,38690,1146,FR,118,56,62,5,Team Random Map
1875409,Lerri d'Arabia,38693,1146,IT,11,7,4,0,Team Random Map
312043,TrippyBaker,38700,1146,US,49,21,28,0,Team Random Map
741803,Osin Babosin,38718,1145,NA,53,28,25,1,Team Random Map
245652,Lanchester,38722,1145,DE,10,5,5,0,Team Random Map
224584,Kaibara,38732,1145,RU,84,33,51,8,Team Random Map
2376711,ErdmännchenLover,38733,1145,DE,10,6,4,0,Team Random Map
1967464,julienventalon,38755,1145,FR,10,5,5,0,Team Random Map
1838112,Kolorikeen,38761,1145,FR,87,34,53,1,Team Random Map
1124546,GravierRose2877,38772,1144,NA,82,40,42,3,Team Random Map
615651,MeAtPiEsAuSaGeRoLl,38778,1144,GB,111,48,63,3,Team Random Map
239532,superpizza,38781,1144,FR,71,33,38,4,Team Random Map
797146,Didzzz§!,38837,1143,FR,22,6,16,0,Team Random Map
648301,Franz Exotic,38843,1143,DE,59,24,35,0,Team Random Map
560266,Ukanlos,38846,1143,US,55,29,26,1,Team Random Map
236209,Villano,38853,1143,MX,39,18,21,2,Team Random Map
2477644,FURY,38876,1143,AR,52,20,32,1,Team Random Map
2288692,MacheteOrigine,38889,1143,FR,17,10,7,1,Team Random Map
1468610,drachs1337,38927,1143,DE,33,16,17,0,Team Random Map
1308529,./Bichito de luZ,38933,1143,FR,13,8,5,0,Team Random Map
119471,JinX,38956,1142,GB,15,9,6,0,Team Random Map
2531112,Brandland,38962,1142,NL,66,33,33,1,Team Random Map
2209759,Impubere,38979,1142,GB,21,13,8,1,Team Random Map
2167398,A1ienWut,38985,1142,DE,11,4,7,1,Team Random Map
2122268,StarKiller,38987,1142,AR,27,12,15,1,Team Random Map
1941623,[PFB] thedomuu,38994,1142,CH,25,8,17,0,Team Random Map
1884315,Bingbao,38996,1142,CN,17,8,9,2,Team Random Map
1835602,hannibal,38998,1142,BR,27,14,13,2,Team Random Map
2563958,Phillron,39031,1141,SE,39,14,25,0,Team Random Map
2074575,Pene de niño rabioso,39049,1141,CL,23,12,11,2,Team Random Map
1555038,Freestyler,39068,1141,US,12,7,5,0,Team Random Map
1278495,Seenk,39074,1141,CL,99,41,58,2,Team Random Map
2374441,Leo,39104,1140,BR,19,10,9,0,Team Random Map
2301186,OverPond1093,39107,1140,NA,18,9,9,0,Team Random Map
2144780,Michael Lewis,39112,1140,FR,121,39,82,2,Team Random Map
1971625,Muchella!,39118,1140,DE,105,47,58,3,Team Random Map
1778079,Wenchobaba,39126,1140,IN,50,21,29,1,Team Random Map
1453987,Alcyon,39134,1140,FR,79,31,48,0,Team Random Map
1253292,Wasp387,39139,1140,FR,17,9,8,0,Team Random Map
1068936,AndFre,39141,1139,DE,28,15,13,0,Team Random Map
465600,HxV,39152,1139,US,21,10,11,0,Team Random Map
228295,SirL3n,39153,1139,DE,12,5,7,0,Team Random Map
1995368,Chri$tian,39183,1139,DE,21,11,10,0,Team Random Map
864184,sbo82,39208,1138,DE,16,4,12,1,Team Random Map
2333413,FIZIK,39239,1138,NL,77,34,43,1,Team Random Map
2032256,Putin,39254,1138,US,115,56,59,0,Team Random Map
1973677,Busk,39255,1138,DK,28,13,15,1,Team Random Map
279232,RIPPED CHIMP,39270,1137,IT,144,58,86,6,Team Random Map
651793,Robert,39347,1136,BR,10,6,4,0,Team Random Map
2369882,yaramazkarga,39376,1136,TR,22,12,10,1,Team Random Map
2056515,Sean,39387,1136,CA,55,26,29,1,Team Random Map
462339,Qué tenemos Ramírez?,39429,1135,MX,17,10,7,0,Team Random Map
2462038,Malkoçoğlu_!!!,39442,1135,TR,121,51,70,3,Team Random Map
2241476,YeraoO,39452,1135,NA,16,9,7,1,Team Random Map
1908739,freaKettOne,39461,1135,NA,157,72,85,4,Team Random Map
1898458,Lluç Pallús,39462,1135,ES,19,8,11,0,Team Random Map
1873628,Bror_S,39463,1135,DE,15,7,8,1,Team Random Map
1480634,allenstyle912,39474,1135,TW,17,8,9,1,Team Random Map
1041725,spunkete,39480,1134,GB,66,29,37,0,Team Random Map
2232131,nayo151,39511,1134,FR,32,15,17,1,Team Random Map
2212383,manusmoccie,39512,1134,NA,67,30,37,4,Team Random Map
1968759,Burt_Macklin_FBI,39524,1134,DK,10,6,4,0,Team Random Map
1914370,Rebeyne_Xcr,39527,1134,FR,24,11,13,0,Team Random Map
1863128,aquosphone3,39534,1134,JP,156,59,97,7,Team Random Map
1512467,Louisonot,39546,1134,FR,103,43,60,2,Team Random Map
200845,MrMeseeks,39547,1134,US,244,93,151,7,Team Random Map
1475211,Bastard,39607,1133,NL,48,25,23,1,Team Random Map
2565990,MrFox5966,39639,1132,NA,14,9,5,1,Team Random Map
1534182,xSoSiicK,39665,1132,DE,26,12,14,0,Team Random Map
2506228,Gocky on Twitch,39697,1131,CA,17,7,10,0,Team Random Map
2061955,Crasken,39713,1131,FI,15,5,10,0,Team Random Map
1673876,chris_field,39729,1131,GB,21,12,9,0,Team Random Map
1028249,Linksträger,39737,1130,CH,64,32,32,0,Team Random Map
969511,feocartman,39738,1130,CR,69,29,40,2,Team Random Map
705282,romankirjanov92,39745,1130,RU,194,83,111,11,Team Random Map
2410140,rUserious,39759,1130,DE,37,18,19,0,Team Random Map
2295913,Žø®ßᾇ™,39763,1130,BR,25,12,13,1,Team Random Map
2038596,Sulion,39772,1130,ES,48,23,25,1,Team Random Map
452004,Ozymandias,39817,1129,AR,39,18,21,2,Team Random Map
2384551,emperor poopatine,39832,1129,BR,36,17,19,4,Team Random Map
334497,Dom,39857,1129,NL,81,40,41,1,Team Random Map
320821,Twitch | AndyPlum,39861,1129,NZ,10,4,6,0,Team Random Map
993048,Akeron,39880,1128,FR,73,32,41,0,Team Random Map
739293,guirosario,39888,1128,BR,62,29,33,4,Team Random Map
249541,MaNueL GaLLeGo,39891,1128,ES,49,24,25,1,Team Random Map
1836830,unflappable,39937,1128,AU,100,43,57,3,Team Random Map
1820705,Luk1zy,39939,1128,BR,170,67,103,7,Team Random Map
1769328,Cpt_Ragequote,39941,1128,DE,143,64,79,5,Team Random Map
1619142,Diak81,39944,1128,GR,14,7,7,0,Team Random Map
2699718,AndreaKPiermart,39974,1127,NA,12,4,8,0,Team Random Map
2408585,carlitosgodoy90,39989,1127,PY,12,6,6,1,Team Random Map
2069063,Lucenzo,40003,1127,CL,60,23,37,3,Team Random Map
637994,Rayleigh,40044,1126,SA,23,9,14,1,Team Random Map
2317793,Cesaro,40067,1126,CO,30,15,15,2,Team Random Map
2120091,Maus,40077,1126,CL,39,20,19,1,Team Random Map
1959696,Juansvoleta,40083,1126,CL,30,16,14,1,Team Random Map
1870323,Fluxxify,40089,1126,US,14,7,7,0,Team Random Map
2692623,Adunak,40120,1125,ES,17,9,8,0,Team Random Map
2056436,LucaNs27,40144,1125,NA,40,20,20,0,Team Random Map
1680790,ChuckDeezy,40164,1125,US,79,36,43,2,Team Random Map
625655,Rob,40184,1124,GB,34,12,22,0,Team Random Map
588174,LiSis,40185,1124,US,53,26,27,0,Team Random Map
229171,Kayros,40188,1124,AR,95,45,50,6,Team Random Map
2252347,gregoire.schiller,40207,1124,FR,96,51,45,2,Team Random Map
1968898,Nomeh,40222,1124,FR,20,7,13,0,Team Random Map
2060729,wonkskela,40277,1123,FR,67,34,33,2,Team Random Map
1899728,_gwer_,40287,1123,DE,46,18,28,1,Team Random Map
1892974,Crispy Fish,40288,1123,US,63,30,33,6,Team Random Map
1839346,NeedaMedic,40290,1123,GB,25,12,13,0,Team Random Map
289340,Le Quack,40304,1123,CL,12,8,4,0,Team Random Map
1990046,Florist,40350,1122,IN,31,9,22,1,Team Random Map
1490608,Bobinosaure,40357,1122,FR,98,49,49,0,Team Random Map
57429,Dan1elx99,40361,1122,NA,39,23,16,2,Team Random Map
867045,Sopaipleto,40373,1121,CL,12,5,7,2,Team Random Map
391719,Slapmynutsackandcallmepapa,40388,1121,US,10,6,4,0,Team Random Map
2360816,Dodu,40392,1121,FR,66,28,38,1,Team Random Map
2213997,ufuksas,40399,1121,TR,37,11,26,3,Team Random Map
1964790,Behemut,40410,1121,FR,41,19,22,0,Team Random Map
1653879,eloyserranocano,40417,1121,ES,12,7,5,0,Team Random Map
1314924,Aushine,40422,1121,FR,19,8,11,0,Team Random Map
1238373,Dodgers Black Mambas Strike <3,40424,1121,TN,54,23,31,10,Team Random Map
807442,F4c4,40435,1120,NA,27,14,13,4,Team Random Map
2424900,eu dota ez,40449,1120,CN,26,13,13,0,Team Random Map
2096430,Pitchoune,40460,1120,BE,14,8,6,0,Team Random Map
1218169,anmolmaly,40483,1120,IN,46,23,23,2,Team Random Map
2258547,Scamazon,40513,1119,IE,17,9,8,1,Team Random Map
2098641,Guigui,40517,1119,FR,12,6,6,0,Team Random Map
2023058,Manchops21,40523,1119,NA,10,6,4,1,Team Random Map
1989553,baneden77,40526,1119,US,19,12,7,1,Team Random Map
1921720,cackyroche,40530,1119,US,89,43,46,1,Team Random Map
1884067,Chab Atta,40536,1119,IT,27,12,15,0,Team Random Map
324540,Ed.,40542,1119,US,57,28,29,1,Team Random Map
1230789,DrUniverse,40551,1119,US,87,34,53,0,Team Random Map
1992548,Gambadou,40601,1118,FR,83,38,45,2,Team Random Map
1526782,zom-bi,40618,1118,AT,10,5,5,0,Team Random Map
691913,Toss a coin,40625,1117,DE,11,5,6,0,Team Random Map
2417037,JDamián1128,40642,1117,PE,77,38,39,5,Team Random Map
2353329,Ins.Nh_ShAgY,40646,1117,EC,192,90,102,7,Team Random Map
2055060,HIGHLINE,40658,1117,AT,10,5,5,0,Team Random Map
1929278,Nathaninho75,40665,1117,FR,16,9,7,0,Team Random Map
1452545,Nextarian,40674,1117,NA,110,43,67,1,Team Random Map
947152,itipt1993,40678,1116,US,47,24,23,1,Team Random Map
2315762,AndreB.,40717,1116,DE,54,28,26,4,Team Random Map
1619102,Macri,40743,1116,AR,25,10,15,3,Team Random Map
719249,Hadramut,40757,1115,DE,31,15,16,3,Team Random Map
2224651,Decoy quack,40785,1115,DE,10,5,5,0,Team Random Map
2127935,NerfedGenius,40792,1115,TR,21,9,12,0,Team Random Map
2107093,29,40795,1115,IN,56,28,28,0,Team Random Map
2028198,birrasx,40798,1115,NA,35,15,20,1,Team Random Map
386944,Davjen,40839,1114,IT,16,8,8,1,Team Random Map
2254401,scott,40848,1114,GB,15,7,8,1,Team Random Map
1984545,Blenzed,40860,1114,US,24,14,10,0,Team Random Map
303591,El CID,40878,1114,US,547,226,321,30,Team Random Map
470242,MagnificentPieceO'Pig,40897,1113,AR,15,6,9,4,Team Random Map
2349030,SoloMun,40906,1113,AR,21,10,11,0,Team Random Map
1509633,Göbeklitepe,40951,1113,TR,22,11,11,1,Team Random Map
836417,juaco,40962,1112,CL,44,18,26,1,Team Random Map
2403496,Whiskey517,40980,1112,US,11,6,5,0,Team Random Map
2379131,mrturtle,40983,1112,GB,10,6,4,1,Team Random Map
2320486,^4Master ^3of ^2RKO,40986,1112,DE,21,13,8,1,Team Random Map
2152243,bluecloud,40996,1112,BE,16,6,10,1,Team Random Map
2062893,Gladiator,41002,1112,GR,201,86,115,13,Team Random Map
2416126,Magheeta,41032,1111,GB,60,30,30,1,Team Random Map
2332454,johannes.marynissen,41036,1111,BE,26,13,13,0,Team Random Map
2137293,Cizna,41045,1111,MX,97,42,55,9,Team Random Map
2101075,Lord Julian8133,41048,1111,NA,273,114,159,23,Team Random Map
2026838,Skullbreak TV,41054,1111,FR,12,6,6,0,Team Random Map
2247528,Valtteri BOTtas,41118,1110,GB,133,65,68,2,Team Random Map
219146,Eltapiax,41135,1110,CL,10,6,4,1,Team Random Map
922734,Brad Pitt,41144,1109,NL,25,11,14,0,Team Random Map
416071,Daniel395,41157,1109,CO,10,3,7,3,Team Random Map
2179557,CockSpanker2000,41173,1109,US,55,26,29,0,Team Random Map
1806466,perfektionist77,41193,1109,DE,28,16,12,0,Team Random Map
466296,leutzsch-1964,41220,1108,DE,92,45,47,5,Team Random Map
2656946,Adriama Lina,41224,1108,TR,15,8,7,0,Team Random Map
2565160,Shadder2k,41229,1108,AU,96,44,52,2,Team Random Map
2475864,One Love Nadine,41234,1108,FR,26,15,11,0,Team Random Map
2340672,Goblin,41244,1108,FR,20,8,12,2,Team Random Map
2323368,BigBoiSam,41247,1108,GB,64,31,33,1,Team Random Map
2126938,MeneerMellema,41257,1108,NA,23,10,13,3,Team Random Map
2098035,Nerevar43,41261,1108,FR,26,9,17,0,Team Random Map
2082385,MrBlueJack,41263,1108,FR,11,6,5,0,Team Random Map
1007890,AlexNavas,41289,1107,DE,23,10,13,0,Team Random Map
2587658,bilpls95,41311,1107,SG,29,13,16,0,Team Random Map
2108504,No Drama Lama,41334,1107,DE,104,46,58,2,Team Random Map
2063811,lgongcar,41336,1107,ES,19,9,10,0,Team Random Map
1938910,sjmckenna42,41347,1107,US,269,119,150,8,Team Random Map
1566296,Andy Ritter,41354,1107,DE,26,9,17,0,Team Random Map
1002163,Mike Jones,41370,1106,GB,15,6,9,0,Team Random Map
2307981,Verity,41394,1106,PT,13,4,9,0,Team Random Map
2254830,ϟTripitaϟ,41398,1106,PE,30,13,17,2,Team Random Map
1952698,stuchlik32,41409,1106,DK,15,6,9,1,Team Random Map
437318,Robbyn Arzuhl,41430,1105,NA,22,9,13,2,Team Random Map
2403863,sim321,41446,1105,GB,69,32,37,0,Team Random Map
1863015,野蠻,41472,1105,HK,62,23,39,1,Team Random Map
1312854,AlCabone85,41489,1105,NA,24,11,13,0,Team Random Map
986768,StarDrux,41499,1104,PT,130,54,76,8,Team Random Map
206949,jokerino,41503,1104,AU,25,15,10,1,Team Random Map
798978,Viking,41504,1104,NL,19,9,10,0,Team Random Map
2450311,akiffgenc,41529,1104,TR,91,41,50,2,Team Random Map
2303692,bultaco78,41535,1104,ES,71,29,42,0,Team Random Map
2070478,Doud,41547,1104,FR,73,37,36,4,Team Random Map
2598060,Potter,41599,1103,GB,18,5,13,1,Team Random Map
1955385,Belowknee,41637,1103,US,33,18,15,4,Team Random Map
1710429,JEAN LUC DE LA RUE,41641,1103,FR,27,11,16,1,Team Random Map
1487205,Neaako,41651,1103,FR,19,11,8,0,Team Random Map
1177211,jans,41661,1102,DE,75,34,41,2,Team Random Map
692346,Hàken,41668,1102,FR,63,31,32,1,Team Random Map
2199668,Th9M5dHatter,41708,1102,NA,29,11,18,2,Team Random Map
1881340,Sheep,41726,1102,DE,18,9,9,1,Team Random Map
1693974,Pablo Escobar,41730,1102,SI,34,13,21,0,Team Random Map
1685215,Asguard,41731,1102,AT,18,7,11,0,Team Random Map
177934,Cisquinho,41758,1101,BR,25,14,11,1,Team Random Map
581064,Exodo Comunista,41760,1101,NA,133,44,89,7,Team Random Map
427965,Helink2003,41765,1101,TW,12,7,5,0,Team Random Map
2117146,gaab,41786,1101,FR,17,10,7,0,Team Random Map
1913519,whosayin,41799,1101,TR,25,11,14,1,Team Random Map
1517623,Astronothing,41808,1101,RO,45,17,28,1,Team Random Map
226498,Vipers,41826,1100,GB,122,62,60,2,Team Random Map
2485033,antoinejammin,41836,1100,FR,162,69,93,5,Team Random Map
2477811,Lil Mattum,41837,1100,PE,112,58,54,2,Team Random Map
2078113,djodjo,41855,1100,BE,33,16,17,1,Team Random Map
1937722,hicheng,41859,1100,CN,17,4,13,0,Team Random Map
1085673,Quinten,41876,1099,BE,13,7,6,0,Team Random Map
913222,fve,41880,1099,BE,26,13,13,0,Team Random Map
2029106,On error resume next,41916,1099,TR,174,76,98,53,Team Random Map
270292,ColinMacLaren,41948,1098,DE,50,19,31,2,Team Random Map
2264370,YungSharis,41978,1098,CA,15,7,8,1,Team Random Map
1878053,cherryeg,41997,1098,US,56,25,31,2,Team Random Map
1469974,DumDum,42004,1098,BE,12,7,5,0,Team Random Map
2086592,FlyDutch1,42044,1097,NA,105,52,53,7,Team Random Map
1945580,Travesty,42052,1097,US,14,7,7,0,Team Random Map
1903199,MONGOLÅYD,42054,1097,NO,56,30,26,0,Team Random Map
1864384,neoweyss,42059,1097,FR,16,10,6,0,Team Random Map
1345868,valoatm,42069,1097,ES,75,37,38,2,Team Random Map
876556,Quesada,42079,1096,BE,74,34,40,5,Team Random Map
2022211,Berky,42111,1096,BE,42,20,22,1,Team Random Map
1975931,Alex444,42187,1095,IT,93,42,51,1,Team Random Map
2521379,Rio,42231,1094,SE,35,18,17,0,Team Random Map
2236834,sopadomacaco,42247,1094,AR,18,8,10,0,Team Random Map
1991256,bene-huber,42260,1094,DE,31,14,17,1,Team Random Map
1425102,Mimolette,42273,1094,FR,18,8,10,0,Team Random Map
718437,Madsmuffi,42284,1093,DK,27,9,18,0,Team Random Map
2567294,Gryphonn,42295,1093,GB,12,7,5,1,Team Random Map
2400360,Danny_93,42305,1093,GB,14,8,6,0,Team Random Map
2392609,joshlax130,42306,1093,US,45,18,27,1,Team Random Map
2191389,sunnylht,42314,1093,HK,15,8,7,0,Team Random Map
1898299,Lando893759,42328,1093,NA,68,22,46,2,Team Random Map
793215,Kasparus,42351,1092,PL,108,51,57,11,Team Random Map
1991268,Antonio,42382,1092,SE,66,30,36,4,Team Random Map
1977655,Cacu Cesa,42383,1092,AR,10,5,5,0,Team Random Map
2681525,El Tata Pinochet,42422,1091,CL,11,5,6,0,Team Random Map
2403689,martcamposleyba,42430,1091,AR,22,11,11,0,Team Random Map
2032606,Skyrec,42447,1091,MX,83,37,46,2,Team Random Map
1977824,69 Love,42451,1091,BR,25,8,17,1,Team Random Map
901379,White snipe,42475,1090,NO,15,6,9,0,Team Random Map
1949250,[Medula] moss07,42523,1090,DE,89,39,50,5,Team Random Map
267018,GzKernel,42534,1089,ES,135,62,73,1,Team Random Map
2008185,Emmacampuzano96,42576,1089,AR,60,24,36,5,Team Random Map
1987837,LifeNote,42579,1089,FR,74,32,42,2,Team Random Map
1044120,thiagogrimberg57,42607,1088,AR,20,8,12,2,Team Random Map
2392673,Ante!!!,42634,1088,DE,22,10,12,0,Team Random Map
2274751,OhSnapItsRap,42642,1088,NA,14,5,9,0,Team Random Map
268627,Vitin,42680,1087,BR,142,61,81,14,Team Random Map
2230885,theguiltyparty,42702,1087,GB,15,10,5,0,Team Random Map
1966835,fred,42713,1087,US,25,11,14,0,Team Random Map
1727695,Hebele,42722,1087,TR,92,43,49,5,Team Random Map
104187,Aussie_CrocHunter,42735,1086,AU,11,6,5,1,Team Random Map
643561,ChoppervonSavoyen,42740,1086,TR,60,22,38,2,Team Random Map
2513599,Philarious,42752,1086,DE,27,12,15,0,Team Random Map
2009998,gachelin.thomas596,42778,1086,FR,25,11,14,0,Team Random Map
1838344,WhatIsThis,42789,1086,US,28,14,14,0,Team Random Map
1602371,doggo,42792,1086,DE,17,7,10,0,Team Random Map
827428,luiiz209,42804,1085,MX,18,7,11,4,Team Random Map
2520455,Leonidas,42825,1085,TR,92,43,49,7,Team Random Map
2517383,SpartanLord375,42826,1085,AE,21,7,14,0,Team Random Map
2488450,Deinos,42828,1085,NL,13,6,7,0,Team Random Map
2406096,iibreesus,42832,1085,US,13,7,6,2,Team Random Map
2267311,littleroo,42838,1085,FR,23,12,11,3,Team Random Map
1391246,chicken_noodle_soup,42859,1085,US,81,28,53,0,Team Random Map
940605,Spinati,42866,1084,DE,137,61,76,7,Team Random Map
2628046,jSUIS Rébou'S,42878,1084,FR,37,16,21,3,Team Random Map
2420346,BlackSpell,42886,1084,AR,55,20,35,1,Team Random Map
372169,MasterLuks,42896,1084,DE,26,12,14,3,Team Random Map
1860907,Langda Tyagi,42916,1084,FR,12,6,6,0,Team Random Map
2130870,PaRaDiZze Yz,42953,1083,NA,80,35,45,2,Team Random Map
1887918,Swagfag comeback,42969,1083,NO,32,13,19,7,Team Random Map
1808855,sagaz0022,42971,1083,BR,159,57,102,5,Team Random Map
1769701,aoe2Master,42972,1083,NA,33,18,15,3,Team Random Map
1337413,snell590,42984,1083,FR,293,117,176,6,Team Random Map
1206277,OfficerBLT,42988,1083,US,11,5,6,0,Team Random Map
913615,McGypsie,42996,1082,US,29,15,14,0,Team Random Map
2095871,ProPosition Joe,43031,1082,GE,48,27,21,0,Team Random Map
1405887,griecojake,43049,1082,US,61,27,34,1,Team Random Map
2642409,saul.jam,43066,1081,ES,13,9,4,1,Team Random Map
1937220,Waylender,43098,1081,FR,11,6,5,0,Team Random Map
2709247,Reed,43130,1080,IN,31,12,19,1,Team Random Map
2208970,Moria,43146,1080,AR,19,7,12,0,Team Random Map
1389156,blue_scare.FR,43171,1080,FR,15,7,8,2,Team Random Map
2557850,Tizilator,43189,1079,BR,11,5,6,0,Team Random Map
368697,nico aronna,43203,1079,AR,28,14,14,1,Team Random Map
2115458,TigreDeAnillaco,43206,1079,AR,27,14,13,2,Team Random Map
623615,[RuDeBoYz]Slim,43236,1078,AT,26,11,15,2,Team Random Map
2397464,Romain,43327,1077,FR,75,29,46,11,Team Random Map
2179593,El Hacha el Humano,43335,1077,AR,20,10,10,1,Team Random Map
452594,sEND3r,43361,1076,SI,10,5,5,0,Team Random Map
2579037,eriksss,43365,1076,IT,21,10,11,0,Team Random Map
2536134,Oeketgeek,43370,1076,FR,18,8,10,0,Team Random Map
104803,OpenCircuit,43413,1075,TR,12,4,8,2,Team Random Map
738957,Minecraft Melons,43418,1075,US,67,28,39,9,Team Random Map
2581618,Nacho112321,43428,1075,NA,14,5,9,1,Team Random Map
2099526,Suiketsu,43446,1075,FR,67,25,42,6,Team Random Map
1230459,stringdean,43465,1075,US,13,7,6,0,Team Random Map
1130107,juan.novo,43468,1074,AR,39,18,21,3,Team Random Map
226174,julian_gs21,43481,1074,CO,12,6,6,0,Team Random Map
1901103,julioguridi0,43514,1074,UY,49,23,26,5,Team Random Map
1238466,Tekno,43528,1074,FI,113,43,70,1,Team Random Map
2270848,jbernardo69,43559,1073,US,22,9,13,0,Team Random Map
2295642,iquinteroe23,43652,1071,MX,70,31,39,1,Team Random Map
2035566,tanja_maracuja,43664,1071,CH,68,30,38,2,Team Random Map
1957509,Joe Exotic,43666,1071,DK,25,9,16,0,Team Random Map
1358357,suffotter56,43680,1071,DE,40,15,25,2,Team Random Map
2766539,DJ13etter,43693,1070,TW,12,2,10,0,Team Random Map
2420836,ouzhiyong1991,43704,1070,CA,102,47,55,2,Team Random Map
2399948,Mazel,43706,1070,DE,18,9,9,1,Team Random Map
2060482,holysinner091,43718,1070,NA,12,6,6,5,Team Random Map
2040685,Rock,43719,1070,IT,20,7,13,0,Team Random Map
1840382,Blopapa7,43730,1070,AR,20,11,9,3,Team Random Map
1728835,Wiweed,43734,1070,FR,111,45,66,1,Team Random Map
1326748,edmelenaveet,43741,1070,FR,15,7,8,1,Team Random Map
964623,Tunga,43749,1069,TR,12,7,5,0,Team Random Map
2429028,ErvynKhan,43769,1069,FR,36,19,17,1,Team Random Map
2321686,tnxnaz,43771,1069,GB,13,6,7,2,Team Random Map
2020461,vto_89,43784,1069,ES,48,21,27,3,Team Random Map
2020185,Ares (Yi Nation),43785,1069,ES,48,21,27,9,Team Random Map
1995509,Covid Bryant,43786,1069,ES,27,12,15,0,Team Random Map
1197911,Maxou4563,43808,1069,NA,19,7,12,1,Team Random Map
562952,Wolf,43818,1068,FR,57,27,30,4,Team Random Map
557349,Dia Kurosawa,43819,1068,CL,30,16,14,0,Team Random Map
2432868,AboutDragon8748,43835,1068,NA,37,16,21,1,Team Random Map
2388467,Schnevullock,43838,1068,NA,12,7,5,1,Team Random Map
2409241,jorgegtz42,43896,1067,MX,39,18,21,3,Team Random Map
2207968,daWilliam,43907,1067,DE,20,11,9,0,Team Random Map
1912644,CorkFondleMan,43922,1067,NA,16,6,10,0,Team Random Map
1836733,MaGic,43923,1067,DE,120,51,69,2,Team Random Map
1137630,CallMeNamaren,43934,1066,AT,33,16,17,0,Team Random Map
177736,cmilaa,43936,1066,CL,35,15,20,1,Team Random Map
944861,BarringSanta,43939,1066,SE,145,67,78,4,Team Random Map
2054686,Panthastic,43970,1066,NA,23,10,13,1,Team Random Map
1824893,maprettner,43977,1066,AT,94,43,51,2,Team Random Map
786928,DonVondra,43997,1065,NA,28,11,17,0,Team Random Map
502549,MüzeyyeN,44003,1065,TR,19,6,13,0,Team Random Map
221569,termik,44030,1065,SK,17,9,8,0,Team Random Map
1302453,Peter_Snv,44045,1065,BE,33,16,17,2,Team Random Map
1827178,mateking,44088,1064,CH,53,21,32,2,Team Random Map
762710,colemanjones,44109,1063,US,145,67,78,1,Team Random Map
2422305,[ZPPK]süssi,44130,1063,AT,24,11,13,3,Team Random Map
2179329,real_zaragoza,44139,1063,ES,13,5,8,0,Team Random Map
1853749,mannygcg,44157,1063,AU,10,5,5,0,Team Random Map
869192,blingdoop,44172,1062,US,18,8,10,1,Team Random Map
2313718,Vekerekel,44202,1062,AR,16,7,9,0,Team Random Map
2295985,Matt Warris,44203,1062,NZ,11,2,9,0,Team Random Map
1293092,Ana-logKid,44230,1062,US,88,32,56,15,Team Random Map
533452,alexis.dasilva,44244,1061,FR,22,10,12,0,Team Random Map
2567185,SérdnaVirgós,44251,1061,ES,44,19,25,1,Team Random Map
2448922,flo,44259,1061,FR,26,12,14,0,Team Random Map
1960546,jmvilaro93,44278,1061,UY,12,4,8,1,Team Random Map
700700,SnakeOilSalesman,44293,1060,US,37,11,26,8,Team Random Map
2448447,Tobac Spudley,44306,1060,US,11,6,5,0,Team Random Map
2428525,Wargasm,44307,1060,IE,15,7,8,2,Team Random Map
1964763,thebouch3,44319,1060,US,15,8,7,2,Team Random Map
1882643,Feioso,44325,1060,BR,28,12,16,4,Team Random Map
1335700,Serkan AK,44339,1060,TR,18,8,10,2,Team Random Map
1028509,CHUBBYXO,44342,1059,GB,13,7,6,0,Team Random Map
2496934,Pipor,44357,1059,GB,20,10,10,0,Team Random Map
1999454,nicopizzini92,44380,1059,AR,12,5,7,0,Team Random Map
1594715,DarkIron,44385,1059,AU,20,11,9,0,Team Random Map
1065845,deyie angle,44396,1058,CN,159,58,101,6,Team Random Map
2686258,omostertman,44409,1058,NL,10,7,3,1,Team Random Map
1257557,Gwaihir [CH],44453,1058,CH,34,17,17,0,Team Random Map
2346991,SugaryHades3195,44491,1057,NA,20,10,10,2,Team Random Map
2084496,Zero,44505,1057,DE,34,14,20,2,Team Random Map
1773336,arquidios1722,44521,1057,NA,20,9,11,0,Team Random Map
1226991,oz,44535,1057,DK,24,8,16,0,Team Random Map
815478,Butter,44537,1056,DE,11,5,6,2,Team Random Map
1442848,kenight,44584,1056,HK,19,9,10,1,Team Random Map
1227399,Andermax,44630,1055,CH,28,14,14,8,Team Random Map
658795,--==(^^MASKAZO^^)==--,44636,1054,ES,26,12,14,1,Team Random Map
380289,TheMonkeyPickler,44653,1054,US,16,7,9,2,Team Random Map
2268108,StevenSeagull,44656,1054,DE,46,21,25,1,Team Random Map
2064265,brock.bettilyon,44664,1054,US,10,5,5,1,Team Random Map
1880250,IAmOneWithTheForce,44717,1053,AT,13,7,6,0,Team Random Map
1806937,biohemp,44718,1053,CZ,25,10,15,4,Team Random Map
400186,AGE KING,44749,1052,DE,99,46,53,4,Team Random Map
1958898,MELKER BÄNGSTRÖM,44774,1052,SE,79,31,48,0,Team Random Map
1858636,ismaserna27336,44777,1052,NA,10,5,5,1,Team Random Map
231633,Mackan,44806,1051,SE,23,11,12,1,Team Random Map
945456,Tschanni,44860,1050,DE,81,33,48,14,Team Random Map
764415,the wuiten from Hamme,44865,1050,BE,501,217,284,12,Team Random Map
2378043,Weesy91,44884,1050,GB,52,23,29,1,Team Random Map
2171920,Pointyboykilla,44891,1050,AU,40,17,23,1,Team Random Map
1603818,manned wolf,44907,1050,US,33,16,17,2,Team Random Map
1554443,Theo,44909,1050,CY,90,41,49,1,Team Random Map
1390331,Ari Salcido,44914,1050,NA,12,6,6,0,Team Random Map
1253848,Trantix,44934,1049,DE,20,9,11,0,Team Random Map
375453,SimonRecort,44942,1049,BY,29,11,18,1,Team Random Map
2305744,WhiteEagl,44944,1049,DE,42,16,26,0,Team Random Map
1895235,MisterRedBeans,44963,1049,NZ,23,10,13,0,Team Random Map
1354800,Raper,44971,1049,FR,11,5,6,0,Team Random Map
1254822,|ztrn,44972,1049,DE,16,4,12,0,Team Random Map
1159659,David-sraam,44974,1048,MX,22,12,10,3,Team Random Map
494227,Jean-Jacques Rousseau,44984,1048,DE,120,47,73,5,Team Random Map
2318395,LutZZein,45001,1048,TR,47,22,25,1,Team Random Map
1953918,wzd27,45013,1048,DE,36,15,21,3,Team Random Map
1685472,mattscarlett8,45020,1048,GB,99,41,58,3,Team Random Map
2601329,NuclearChaplin,45054,1047,NZ,21,11,10,0,Team Random Map
2402901,Pong Lenis,45072,1047,TR,39,16,23,0,Team Random Map
359052,Ryu,45082,1047,AT,42,17,25,1,Team Random Map
1908493,akira519.dso,45093,1047,ES,64,27,37,1,Team Random Map
1610392,fyrnach89,45100,1047,DE,20,7,13,1,Team Random Map
2522088,applepiecookie,45122,1046,DE,19,9,10,1,Team Random Map
2076296,Bidderlyn,45140,1046,IL,51,26,25,5,Team Random Map
318012,Usidore the Blue,45154,1046,US,34,15,19,10,Team Random Map
2651563,Magento #13,45176,1045,AR,34,14,20,0,Team Random Map
2521399,Atin,45181,1045,GB,11,5,6,1,Team Random Map
1411825,Anshar,45202,1045,CA,12,5,7,0,Team Random Map
732387,MadMike,45216,1044,FR,33,16,17,1,Team Random Map
2474071,TwoBeers,45231,1044,DE,13,6,7,0,Team Random Map
2465153,eliteDVN3842,45232,1044,NA,11,6,5,0,Team Random Map
2427911,Notorious Guib,45237,1044,FR,72,37,35,1,Team Random Map
853417,Jogginforcancer,45255,1044,US,19,11,8,0,Team Random Map
1787851,turu,45257,1044,FI,59,20,39,1,Team Random Map
1581534,lars_kellner,45262,1044,DE,27,11,16,3,Team Random Map
626033,Aranclanos,45281,1043,AR,12,4,8,1,Team Random Map
2530181,ALmotema,45294,1043,TW,28,13,15,2,Team Random Map
2275600,fisky,45313,1043,GB,85,39,46,1,Team Random Map
1989513,Nobleza,45323,1043,DK,82,39,43,2,Team Random Map
2225772,jl,45365,1042,ES,40,20,20,1,Team Random Map
1171449,VendeurDePoudre,45387,1041,NA,45,18,27,0,Team Random Map
2232706,Pencho8940,45414,1041,NA,169,86,83,4,Team Random Map
1910388,CrisSR,45432,1041,ES,42,17,25,2,Team Random Map
1363656,lepticafé,45494,1040,FR,12,4,8,0,Team Random Map
2653822,DavidVJ18,45510,1039,NA,11,6,5,2,Team Random Map
2119218,Hava,45522,1039,GB,27,10,17,0,Team Random Map
2217256,vizcaino19,45577,1038,MX,38,15,23,0,Team Random Map
1961665,Semenlu,45590,1038,NA,56,23,33,0,Team Random Map
1208843,Ghostavo,45603,1038,ES,17,5,12,1,Team Random Map
479048,Gabriela Cerruti,45615,1037,AR,97,33,64,3,Team Random Map
2401141,eskitepeli,45629,1037,TR,106,49,57,2,Team Random Map
761906,jm.sierra929,45685,1036,CO,107,45,62,3,Team Random Map
639361,DeejayM1CH4,45689,1036,NA,54,23,31,2,Team Random Map
2593424,Drunk Fat Guy,45696,1036,TR,13,6,7,1,Team Random Map
2306099,kellandlhead,45710,1036,US,59,19,40,2,Team Random Map
2089699,COVID-20,45717,1036,US,31,11,20,5,Team Random Map
2027023,Moonracer,45721,1036,DE,14,7,7,0,Team Random Map
1275370,Aanomaly,45739,1036,US,49,20,29,1,Team Random Map
2574995,Abb4don,45754,1035,AR,31,16,15,0,Team Random Map
2390383,sjdlloyd,45759,1035,NZ,12,4,8,1,Team Random Map
2299343,danielsarussi,45761,1035,IL,135,60,75,3,Team Random Map
964775,muusinuija,45800,1034,FI,62,25,37,2,Team Random Map
691763,Supremest08,45806,1034,DE,85,40,45,3,Team Random Map
2276782,jamaciadave1,45824,1034,NA,19,9,10,1,Team Random Map
2067974,Jedrulenko,45832,1034,PL,10,5,5,0,Team Random Map
1515579,Frizer,45853,1034,ES,34,13,21,0,Team Random Map
733103,SwaggerOnAZillion101,45863,1033,AT,28,11,17,4,Team Random Map
2462864,lorenzosanna,45876,1033,NA,21,11,10,1,Team Random Map
1912279,Philip,45896,1033,CO,16,6,10,0,Team Random Map
1875322,ssbm_schlimmshady,45898,1033,DE,10,3,7,0,Team Random Map
2650549,JesusT,45917,1032,ES,40,17,23,2,Team Random Map
2344656,b3gm3,45933,1032,FR,70,31,39,6,Team Random Map
1992953,Broz,45998,1031,FR,17,8,9,1,Team Random Map
570591,N.S.M,46029,1030,CN,268,98,170,7,Team Random Map
459262,Zanaken,46032,1030,US,75,30,45,1,Team Random Map
1690855,punkpommes1,46067,1030,DE,55,23,32,0,Team Random Map
1500829,Borjagronka,46069,1030,ES,88,35,53,1,Team Random Map
2087581,cenkaydin61,46106,1029,TR,11,5,6,1,Team Random Map
1794423,bbrages,46117,1029,US,39,17,22,2,Team Random Map
1171719,Chez Mimil,46125,1028,BE,68,28,40,1,Team Random Map
425381,CaptainPanda,46184,1027,TR,40,16,24,0,Team Random Map
2059557,heimlichManuever,46202,1027,TR,92,36,56,4,Team Random Map
2516332,Nifama,46296,1025,AR,22,10,12,0,Team Random Map
2202853,martindq,46306,1025,BE,20,9,11,1,Team Random Map
2426741,d.heymann,46345,1024,DE,38,17,21,0,Team Random Map
2351808,JØRMUNGANDR,46349,1024,DE,17,5,12,0,Team Random Map
1941654,harkusmuber,46365,1024,DE,33,12,21,3,Team Random Map
2480410,Lore_15,46391,1023,CO,22,9,13,0,Team Random Map
218356,Ye Old William,46418,1023,GB,17,8,9,3,Team Random Map
1237102,Salt_Merchant,46421,1023,AU,127,49,78,0,Team Random Map
556827,leninsanchez23,46431,1022,CO,113,46,67,4,Team Random Map
2596400,Stukax,46436,1022,PT,51,24,27,3,Team Random Map
2371019,freddyfredo1977,46445,1022,NA,18,8,10,3,Team Random Map
2205448,patrick.roberts,46454,1022,DE,27,11,16,0,Team Random Map
1976720,Arxet,46467,1022,FR,26,10,16,1,Team Random Map
917280,Rcard378,46490,1021,AR,10,4,6,3,Team Random Map
898281,EIKX,46492,1021,FR,66,26,40,3,Team Random Map
2442041,gmagne,46510,1021,FR,17,7,10,1,Team Random Map
2414499,SOA5772,46511,1021,NA,24,11,13,0,Team Random Map
2198014,SappYoda,46519,1021,ES,64,28,36,0,Team Random Map
1911189,Enzo95ITA,46532,1021,NA,116,40,76,8,Team Random Map
788724,dawoagepl,46550,1020,PL,117,56,61,7,Team Random Map
1084366,castrepower,46604,1019,ES,14,5,9,1,Team Random Map
497379,Toppy Mc Floppy,46614,1019,DE,41,21,20,2,Team Random Map
2436547,Gkhn,46624,1019,TR,25,12,13,1,Team Random Map
1807370,Kaleen Bhaiya!!!],46699,1018,DE,16,7,9,0,Team Random Map
1239425,mathon.laura,46708,1018,FR,65,27,38,0,Team Random Map
1150058,GGkhan,46710,1017,DE,50,25,25,3,Team Random Map
263883,Bo Binci,46714,1017,AT,150,59,91,5,Team Random Map
41081,Mister Chau,46728,1017,DE,10,4,6,0,Team Random Map
2026258,Fino.,46754,1017,BR,74,28,46,1,Team Random Map
813348,dumtistik,46779,1016,TR,54,20,34,3,Team Random Map
2531792,Zoyty,46788,1016,FI,66,28,38,2,Team Random Map
2326194,Krypo,46799,1016,NA,13,5,8,0,Team Random Map
2258861,kiberto,46803,1016,CL,15,6,9,1,Team Random Map
1951698,Chips,46811,1016,FR,22,9,13,2,Team Random Map
1093078,colaboks11,46819,1015,NO,38,15,23,3,Team Random Map
476861,Dr4gonC0rn,46833,1015,AU,40,15,25,0,Team Random Map
2309696,Cr@zy_RuLo,46844,1015,ES,48,21,27,0,Team Random Map
1905793,Polsky D. Pirateking,46857,1015,ES,29,11,18,0,Team Random Map
269634,immanak,46871,1014,TR,13,5,8,0,Team Random Map
483396,Takeshi Kovacs,46883,1014,CL,11,5,6,0,Team Random Map
2583242,fermito,46891,1014,FR,30,12,18,8,Team Random Map
1961929,tutangamon,46913,1014,AR,38,17,21,2,Team Random Map
2527298,sebdes,46940,1013,FR,14,7,7,0,Team Random Map
2279378,Co,46948,1013,TR,16,6,10,1,Team Random Map
1909645,aragon97,46958,1013,FR,14,6,8,0,Team Random Map
1134903,Floop the pig,46970,1012,GB,19,9,10,0,Team Random Map
671014,帕特里克,46982,1012,DE,23,9,14,0,Team Random Map
2492204,democricci,46990,1012,CL,25,8,17,1,Team Random Map
619036,eqab88,47020,1011,BH,13,3,10,0,Team Random Map
2674182,Ionut137,47064,1010,NA,14,7,7,2,Team Random Map
2603874,slippynipple,47068,1010,NL,41,19,22,0,Team Random Map
2280861,UliNavita,47084,1010,MX,243,97,146,9,Team Random Map
2471631,ByCaKa Erkek Kuaförü,47132,1009,TR,31,11,20,3,Team Random Map
1700338,holycow,47151,1009,FR,30,14,16,0,Team Random Map
2625811,Magoprost Herr Kommandant,47168,1008,BR,62,26,36,1,Team Random Map
2319307,Sandwar8920,47184,1008,NA,132,54,78,12,Team Random Map
2039185,Shade,47196,1008,DE,17,7,10,0,Team Random Map
1853259,mac-sparerib,47209,1008,DE,19,5,14,3,Team Random Map
2657602,fs7,47221,1007,CL,36,12,24,0,Team Random Map
1948265,tomarabhishek326,47248,1007,AU,33,15,18,1,Team Random Map
1427589,ozankeremozcan12,47261,1007,TR,35,15,20,0,Team Random Map
1099780,Hirotaka,47267,1006,US,11,3,8,0,Team Random Map
775138,Adrox25,47272,1006,PL,94,41,53,4,Team Random Map
2609369,Reven,47283,1006,FI,20,9,11,0,Team Random Map
2286988,siyah3169,47294,1006,NA,72,32,40,10,Team Random Map
1723632,Weast,47311,1006,AU,37,11,26,5,Team Random Map
1436498,OeilEclairage8,47359,1005,NA,30,13,17,3,Team Random Map
1728895,Tywin,47399,1004,SE,100,45,55,2,Team Random Map
2440893,IsolatorxD,47424,1003,AR,19,6,13,1,Team Random Map
2284788,j0930585129,47432,1003,TW,111,54,57,6,Team Random Map
1166294,Fobin,47454,1002,DE,11,4,7,0,Team Random Map
2688718,Sionalista,47458,1002,BR,19,8,11,1,Team Random Map
2402570,TheJacobMachine,47464,1002,CA,10,4,6,0,Team Random Map
2309690,Martok,47468,1002,FR,31,13,18,3,Team Random Map
668449,YouCanResignNow,47495,1001,GB,45,23,22,1,Team Random Map
1866116,PitoHNKoAaN2,47534,1001,NA,99,39,60,5,Team Random Map
1233307,Zɔdiac!,47538,1001,FR,29,11,18,0,Team Random Map
898275,CodrinM345,47542,1000,NA,69,29,40,1,Team Random Map
2652096,Blitti,47550,1000,NO,19,7,12,0,Team Random Map
1602673,The Sandman,47575,1000,BE,18,8,10,1,Team Random Map
1990346,YoLK,47612,999,TR,115,39,76,8,Team Random Map
2612076,Seventh Child,47631,998,NZ,23,9,14,1,Team Random Map
1773630,Dazeroth,47660,998,NA,14,6,8,0,Team Random Map
1095328,Nek,47666,997,FR,34,6,28,0,Team Random Map
693170,kamphuis.alex,47709,996,NL,14,7,7,1,Team Random Map
1075433,Overlord,47759,995,MX,13,7,6,0,Team Random Map
1145430,silverappples,47794,994,AU,13,8,5,0,Team Random Map
2664909,Flatcherer,47799,994,AR,56,25,31,0,Team Random Map
1989325,noam456,47818,994,IL,376,152,224,22,Team Random Map
1963009,JerryW,47820,994,TW,17,6,11,1,Team Random Map
1853407,RothEchRoth,47826,994,NA,13,4,9,1,Team Random Map
274457,Sapa Inka,47834,993,PE,37,18,19,2,Team Random Map
2264386,Yetkili Bey,47867,993,TR,14,5,9,0,Team Random Map
212426,Chacho,47893,992,ES,22,10,12,3,Team Random Map
430787,Dr.Strangelove,47896,992,GB,18,9,9,1,Team Random Map
2159202,matthewswilcox,47917,992,US,74,36,38,4,Team Random Map
2437004,†,47955,991,RU,25,12,13,4,Team Random Map
2164242,TomMariusNGX,47967,991,AU,22,7,15,1,Team Random Map
2052022,Maratone,47972,991,DK,18,5,13,0,Team Random Map
2018187,PotroGrande,47973,991,CL,12,4,8,1,Team Random Map
1172204,OffCreature7386,47987,990,NA,79,36,43,12,Team Random Map
2650558,Ever,47997,990,AR,12,5,7,0,Team Random Map
2142116,Peka2216,48015,990,NA,41,17,24,0,Team Random Map
1836601,AgentK,48030,990,FR,23,10,13,1,Team Random Map
1016744,Krog_Gar,48038,989,CH,35,16,19,0,Team Random Map
445312,pzarola,48045,989,CA,16,7,9,0,Team Random Map
2365327,how do i shot web?,48052,989,US,27,10,17,1,Team Random Map
2190330,AJGarcick,48058,989,CO,115,44,71,10,Team Random Map
290372,pintonium,48070,989,US,35,15,20,0,Team Random Map
790505,DeagleFi,48079,988,FR,52,25,27,0,Team Random Map
2525456,Pepuncio,48088,988,ES,38,15,23,1,Team Random Map
2522732,Benito Camela,48089,988,ES,34,14,20,0,Team Random Map
2417237,DeKo,48138,987,DE,37,18,19,0,Team Random Map
2132192,Mr. White,48150,987,ES,18,6,12,0,Team Random Map
2046265,Arrete de te branler va courir !,48154,987,FR,18,9,9,2,Team Random Map
1958512,Dusajs,48155,987,CZ,21,10,11,0,Team Random Map
1765037,stonehands,48163,987,US,28,11,17,1,Team Random Map
1526250,Gunther,48167,987,AU,17,8,9,0,Team Random Map
1933740,giuligenti,48207,986,AR,27,12,15,0,Team Random Map
831607,Ac,48228,985,AU,24,11,13,0,Team Random Map
583418,Kvothe,48232,985,AR,13,6,7,3,Team Random Map
2113856,djo.lancaster,48242,985,GB,16,8,8,0,Team Random Map
1462604,Rex,48295,984,IE,27,13,14,0,Team Random Map
2084403,Flyjdix11,48319,983,US,75,30,45,1,Team Random Map
2681224,Shadbase,48396,981,NL,10,2,8,0,Team Random Map
2360884,noninonal,48408,981,FR,48,15,33,1,Team Random Map
870827,SpX,48434,980,AR,48,14,34,3,Team Random Map
2413135,Tadelo4946,48451,980,NA,33,15,18,0,Team Random Map
2307693,Melveengg,48456,980,FR,38,15,23,4,Team Random Map
2690497,GHALILBABA,48484,979,AU,41,20,21,0,Team Random Map
2308503,Jugador59663599,48496,979,NA,23,3,20,3,Team Random Map
2034798,喜咧亂小,48504,979,TW,44,14,30,1,Team Random Map
2020379,sikilatci,48538,978,TR,59,16,43,4,Team Random Map
2273120,xalvaje,48612,976,CO,50,24,26,2,Team Random Map
2126728,Kardinale425,48614,976,NA,15,5,10,0,Team Random Map
2451658,Luoar,48642,975,NA,26,11,15,2,Team Random Map
1719505,Towers,48672,975,DK,89,46,43,1,Team Random Map
2135970,TheConquero,48700,974,PE,43,13,30,5,Team Random Map
1987669,Bert the wise,48703,974,NA,34,12,22,0,Team Random Map
1610679,CandyMan,48712,974,RU,133,47,86,8,Team Random Map
1562020,Sentre47680,48713,974,NA,13,6,7,0,Team Random Map
1382159,Calyst,48716,974,FR,65,28,37,2,Team Random Map
1266261,Wooden Trebuchet,48717,974,IN,109,51,58,5,Team Random Map
2644610,ianskywalker,48729,973,CL,12,5,7,0,Team Random Map
2335213,guiguifal,48745,973,FR,19,7,12,2,Team Random Map
1843192,lekivita,48760,973,AU,69,22,47,4,Team Random Map
2185575,raynor11,48797,972,US,15,7,8,0,Team Random Map
2041101,Wath Fortich,48804,972,NA,73,29,44,2,Team Random Map
2439895,dalessandropatricio,48827,971,AR,14,7,7,0,Team Random Map
1692267,LordHenron99,48842,971,NA,36,16,20,0,Team Random Map
2169225,arazbabazadeh,48873,970,NO,84,39,45,0,Team Random Map
1981149,julianobizzo9,48878,970,BR,82,33,49,2,Team Random Map
1521185,Gonza IV,48883,970,NA,18,7,11,3,Team Random Map
1270353,Choooc,48886,970,FR,57,20,37,4,Team Random Map
85080,Lorenz051,48894,969,FR,59,23,36,1,Team Random Map
2412527,voltapette,48903,969,FR,48,21,27,1,Team Random Map
1378706,trawn,48927,969,FR,60,25,35,3,Team Random Map
2526183,LeoDN12,48941,968,NA,17,6,11,1,Team Random Map
2342356,ZatakSucks,48947,968,US,23,10,13,3,Team Random Map
2035048,berend604,48953,968,NA,19,8,11,2,Team Random Map
1314144,neiney,48960,968,FR,18,4,14,2,Team Random Map
2409604,KAOS,48972,967,AR,20,8,12,4,Team Random Map
1779481,2baker7,49032,966,ES,18,7,11,0,Team Random Map
1356104,Chryasor,49037,966,SE,19,8,11,2,Team Random Map
2364864,Emunchkinboy,49057,965,US,26,9,17,0,Team Random Map
546650,TiGer,49081,964,DE,41,18,23,2,Team Random Map
2650248,.jung,49084,964,BR,35,14,21,0,Team Random Map
2613770,1-TAP,49086,964,AE,18,8,10,1,Team Random Map
2524374,PianoChip819568,49094,964,NA,16,5,11,0,Team Random Map
2222297,Red-One,49106,964,BE,13,7,6,0,Team Random Map
1239429,superiperfabietto,49109,964,IT,12,4,8,1,Team Random Map
2334269,DAAAAAAAAAAMN,49142,963,GR,40,20,20,1,Team Random Map
1751146,G4LO,49189,962,DE,11,3,8,1,Team Random Map
1714701,Neuronwake,49191,962,US,40,16,24,0,Team Random Map
2326266,Disabled Potato,49215,961,US,95,45,50,4,Team Random Map
2573764,anderz,49246,960,BR,97,45,52,1,Team Random Map
2409938,YARRR!!!,49254,960,US,43,12,31,0,Team Random Map
2392748,dominusz,49255,960,US,62,29,33,0,Team Random Map
2204443,Alex,49265,960,IT,33,12,21,1,Team Random Map
1969803,dadou679,49272,960,NA,115,48,67,4,Team Random Map
1808667,daviddosch,49279,960,US,98,43,55,3,Team Random Map
345564,sunny_32156,49308,959,CN,58,21,37,23,Team Random Map
1416002,Boris,49317,959,FR,61,25,36,1,Team Random Map
2599141,dub,49333,958,AR,42,14,28,0,Team Random Map
2515323,EVIL PAPAGALI ;,49338,958,BR,56,25,31,2,Team Random Map
2356662,Vincitore7,49350,958,NL,34,14,20,2,Team Random Map
2228222,hitekk00,49355,958,HU,24,11,13,0,Team Random Map
875883,LuciD,49377,957,GB,74,30,44,3,Team Random Map
2708418,Yuukinae,49384,957,US,12,5,7,0,Team Random Map
2145785,agarciabianchi,49399,957,UY,56,21,35,6,Team Random Map
1205000,mkannstein,49403,957,DE,24,11,13,1,Team Random Map
1966227,puda-club,49404,957,DE,35,10,25,3,Team Random Map
1474252,vnct,49411,957,FR,29,12,17,4,Team Random Map
2074059,levipower91,49436,956,AU,38,14,24,0,Team Random Map
2452820,Stgojavier,49466,955,CL,12,5,7,0,Team Random Map
2409280,julipro7207,49467,955,NA,13,5,8,2,Team Random Map
1868221,AlbertoMMC,49481,955,ES,49,25,24,0,Team Random Map
2590454,karan_vibgyor,49498,954,CA,57,24,33,0,Team Random Map
2425455,Kuro Shiro,49506,954,IN,19,7,12,2,Team Random Map
1630231,chrisloverx62,49519,954,FR,40,21,19,0,Team Random Map
2641330,__ƒℓééχ,49535,953,DE,14,4,10,0,Team Random Map
2515593,viagem perdida,49537,953,BR,117,53,64,1,Team Random Map
2216204,Peter',49571,952,UY,91,37,54,5,Team Random Map
2719846,Sanderdb,49600,951,NL,14,5,9,0,Team Random Map
2388524,jbman35,49610,951,FR,45,19,26,0,Team Random Map
2346480,Ramadeckel,49612,951,DE,42,19,23,1,Team Random Map
2268397,Rasyani,49617,951,BE,18,6,12,0,Team Random Map
84605,verdugo94,49641,950,ES,35,10,25,2,Team Random Map
1452305,Ziggy,49672,950,AU,14,6,8,0,Team Random Map
2691580,omaruk1,49683,949,GB,35,15,20,1,Team Random Map
2114193,ChusElSanto,49696,949,NA,56,24,32,0,Team Random Map
2066776,yoyomartel,49698,949,FR,10,2,8,1,Team Random Map
1592783,karankaiga123,49743,948,NA,14,5,9,0,Team Random Map
1553817,[POST] Der König,49744,948,DE,126,42,84,1,Team Random Map
1519728,GregsKakadu,49773,947,DE,32,11,21,6,Team Random Map
619904,A Flying Nun,49785,946,DE,20,10,10,0,Team Random Map
1926865,ajklump24,49809,946,US,60,25,35,5,Team Random Map
2380931,giuseppe.alberti,49826,945,IT,32,9,23,1,Team Random Map
2051695,JONES 3269,49830,945,MX,144,58,86,3,Team Random Map
1925397,Karmo,49835,945,FR,70,25,45,0,Team Random Map
846699,levjoe,49848,944,CA,36,14,22,0,Team Random Map
674125,De.Wehrmacht,49850,944,DE,77,30,47,3,Team Random Map
2706492,daniel.kriwet,49857,944,DE,12,5,7,0,Team Random Map
1977980,Fausty92,49881,944,FR,110,42,68,5,Team Random Map
1594995,RemK,49893,944,FR,56,22,34,0,Team Random Map
1723697,Ghostxluks,49922,943,NA,34,15,19,3,Team Random Map
2545496,m3rc3ditas,50007,940,ES,19,6,13,2,Team Random Map
1963991,jeanbaptiste.delaporte,50019,940,FR,10,3,7,3,Team Random Map
2324272,Reclhus,50083,938,AR,29,14,15,0,Team Random Map
2030727,Janohi,50127,937,CO,34,12,22,5,Team Random Map
551621,BaC,50171,935,CH,85,33,52,1,Team Random Map
407938,Gravy,50172,935,CA,19,5,14,2,Team Random Map
1083404,Jared,50198,934,TW,33,8,25,0,Team Random Map
881837,Tides,50203,934,US,21,7,14,0,Team Random Map
2196020,Bulbik,50221,934,SK,96,36,60,0,Team Random Map
2013329,alpinoeisbaer,50226,934,AT,48,27,21,1,Team Random Map
2575606,AAA,50245,933,TR,31,13,18,1,Team Random Map
1579610,rvlander,50269,933,FR,31,12,19,0,Team Random Map
308316,ElChiefPablo,50270,933,NA,34,13,21,1,Team Random Map
2347937,lorenzforster,50284,932,DE,21,7,14,0,Team Random Map
1963687,Saksagan,50292,932,TR,71,27,44,4,Team Random Map
479007,bbullet2,50340,930,US,44,15,29,1,Team Random Map
2158056,muratozuymazz,50357,930,TR,11,3,8,0,Team Random Map
2079146,Yo Yo Skittles,50360,930,US,150,61,89,4,Team Random Map
2072192,matias,50400,929,AR,33,12,21,2,Team Random Map
1032056,boudiou76,50410,928,NA,13,4,9,0,Team Random Map
487429,Chuck_Norris,50437,927,GB,10,5,5,0,Team Random Map
2398274,Vaskraylas1992,50444,927,NA,46,21,25,1,Team Random Map
214606,alejandrogalpo,50499,925,ES,16,5,11,1,Team Random Map
2615882,aicason,50536,924,ES,52,24,28,1,Team Random Map
2260482,frhancisc,50546,924,CL,64,24,40,3,Team Random Map
2461379,MisterGazz22,50600,922,GB,29,11,18,1,Team Random Map
2002304,afer837,50609,922,US,51,18,33,2,Team Random Map
1948264,Chico,50610,922,FR,59,25,34,1,Team Random Map
1989480,ross.cassidy,50637,921,GB,211,87,124,0,Team Random Map
1287596,Rojas,50646,921,ES,16,4,12,0,Team Random Map
2529644,MightyJungle513,50658,920,NA,19,7,12,11,Team Random Map
1915171,GoutteMetal5031,50666,920,FR,89,38,51,3,Team Random Map
1746839,micriab,50667,920,RO,29,13,16,0,Team Random Map
2019011,Balogna_Police,50688,919,US,35,15,20,1,Team Random Map
1885361,JUAN DEAGLE PLAIN'AXE,50693,919,FR,31,10,21,0,Team Random Map
2473568,Solid Nate,50727,917,US,16,6,10,1,Team Random Map
1314757,Jarsse,50749,917,FI,116,44,72,0,Team Random Map
681216,AlmdBttr,50757,916,US,25,8,17,0,Team Random Map
1948237,HarleyQuinn,50810,915,LT,22,10,12,0,Team Random Map
2544195,onur_sengir,50830,914,TR,74,30,44,2,Team Random Map
2505402,moreill2521,50832,914,US,53,23,30,0,Team Random Map
2323241,Mozartada,50837,914,ES,54,19,35,0,Team Random Map
346741,SushimojiTo,50848,914,IT,66,26,40,0,Team Random Map
2575738,S1mple 2,50859,913,BG,66,32,34,1,Team Random Map
2240809,jamba,50866,913,US,11,5,6,0,Team Random Map
2512726,Axel PR1ME,50888,912,ES,29,11,18,0,Team Random Map
1841570,joebetoblame,50986,909,US,38,16,22,0,Team Random Map
2412184,JarpenLbn,50999,908,NA,42,18,24,1,Team Random Map
511772,Ich1331995,51018,907,AT,16,5,11,0,Team Random Map
1367483,JohnSun,51041,907,US,18,7,11,1,Team Random Map
1334226,TomKetchup9806,51042,907,NA,15,3,12,0,Team Random Map
2569037,SoouZaNT1,51047,906,BR,17,6,11,2,Team Random Map
2442837,***RYUK***,51049,906,TR,39,15,24,2,Team Random Map
1020956,d_can,51077,905,DE,85,28,57,2,Team Random Map
260937,TMountana,51079,905,NA,49,19,30,3,Team Random Map
2361629,Batphan,51089,905,FR,15,7,8,1,Team Random Map
1289702,OrpheusXIII,51105,905,DE,85,28,57,1,Team Random Map
2337755,alejandrobarrios07,51124,904,UY,39,14,25,2,Team Random Map
2081898,Vadiwololo,51152,903,NA,192,76,116,2,Team Random Map
1721753,EGCmargo,51163,903,NA,58,20,38,6,Team Random Map
2456283,semihaslan2017,51180,902,TR,50,11,39,1,Team Random Map
1878851,Ferhat CANKARA,51192,902,TR,25,9,16,0,Team Random Map
1910322,joris_aerden,51218,901,BE,15,5,10,0,Team Random Map
1563435,Novo88,51223,901,MX,38,15,23,0,Team Random Map
474041,naps,51227,900,CL,145,52,93,13,Team Random Map
2620544,RealPlayer49,51229,900,NA,20,7,13,0,Team Random Map
2318084,lgicalado,51274,899,BR,50,19,31,1,Team Random Map
1443040,excited n' shit,51292,899,DE,35,13,22,3,Team Random Map
2525165,bossum,51335,897,AR,33,12,21,5,Team Random Map
671191,LynxEterna,51358,896,DE,53,17,36,0,Team Random Map
419403,Ashy,51359,896,AU,24,8,16,2,Team Random Map
2468169,Code Chigua,51395,895,AR,17,6,11,0,Team Random Map
2059220,SALADIN165887,51404,895,NA,50,20,30,2,Team Random Map
2565286,Opstalmark,51413,894,NL,19,7,12,0,Team Random Map
771741,GreenSoul21,51439,893,IT,89,29,60,3,Team Random Map
499943,Captain Jack Swallows,51442,893,DE,28,8,20,1,Team Random Map
2068983,ChrisChros007,51455,893,NA,38,15,23,3,Team Random Map
2535559,shigeru1853,51473,892,NA,76,34,42,1,Team Random Map
679896,Porfirio Díaz,51488,891,US,10,2,8,1,Team Random Map
2628049,barra12,51521,890,ES,20,7,13,0,Team Random Map
2193925,Bolo,51529,890,BR,12,4,8,0,Team Random Map
1169856,purple кодеин,51546,889,RU,42,18,24,0,Team Random Map
2337862,Hoepelwiel,51564,889,NL,39,16,23,1,Team Random Map
2118332,Ianfdz,51603,888,MX,53,21,32,4,Team Random Map
913388,hakanxwolf,51650,886,TR,149,60,89,1,Team Random Map
429240,[Alpha] Traslanovic,51656,886,DE,94,23,71,5,Team Random Map
2317725,Plazzzyyy,51666,886,NA,60,23,37,2,Team Random Map
1822858,Dead.Shadow,51677,886,US,26,10,16,3,Team Random Map
2422538,Joshawaa,51697,885,AU,40,16,24,0,Team Random Map
2715938,Bumer,51746,883,RU,39,16,23,1,Team Random Map
679536,illid44n1,51771,882,NA,68,32,36,5,Team Random Map
1731046,ibi.zayed,51787,882,DE,18,5,13,3,Team Random Map
2324817,Tiduskold,51835,880,ES,20,6,14,0,Team Random Map
1675475,ekurtyukov,51844,880,RU,20,6,14,2,Team Random Map
2150722,Freibeuter,51867,879,DE,10,2,8,1,Team Random Map
1940271,MobikGo,51910,878,ES,74,19,55,0,Team Random Map
365369,MarcusMaximus,51952,876,DE,18,6,12,0,Team Random Map
1170217,raquet,51966,875,FR,25,8,17,0,Team Random Map
2380764,adammpolak,51977,875,US,54,19,35,4,Team Random Map
2361049,Boowoar,51978,875,DE,14,5,9,0,Team Random Map
1837722,DevilYz,52043,873,CN,16,3,13,0,Team Random Map
2086335,mlanutr,52062,872,IT,24,8,16,1,Team Random Map
2555806,mr.reese,52076,871,TR,156,71,85,8,Team Random Map
2137934,Arjan Smit,52108,870,NL,45,17,28,2,Team Random Map
1746446,Arthurion,52117,870,MX,41,16,25,3,Team Random Map
2561152,g00sling,52129,869,US,15,4,11,3,Team Random Map
1925480,vmjboxing,52160,868,NA,36,15,21,0,Team Random Map
1946290,adamc921,52198,866,US,11,4,7,1,Team Random Map
2504823,schlopod,52214,865,US,45,21,24,0,Team Random Map
2316210,druidcipki,52244,864,PL,65,30,35,1,Team Random Map
2291550,ederps24,52245,864,NA,53,22,31,6,Team Random Map
1611977,teotabd,52256,864,FR,89,34,55,7,Team Random Map
2464885,Bomboklat,52299,862,SK,31,9,22,0,Team Random Map
2205816,298382,52306,862,RU,56,26,30,2,Team Random Map
1475045,Danerpsy,52335,861,NA,40,15,25,10,Team Random Map
2752099,WD GREEN,52337,860,ID,26,9,17,0,Team Random Map
2280404,Thorjim1958,52343,860,NA,49,15,34,0,Team Random Map
1292366,Early,52352,860,FR,165,57,108,8,Team Random Map
641997,I am not crazy,52377,858,SK,41,13,28,0,Team Random Map
1988677,Elchuekin,52393,858,AR,19,4,15,0,Team Random Map
2019439,Facu,52413,857,AR,51,19,32,1,Team Random Map
1932559,benconsci,52414,857,IT,116,48,68,3,Team Random Map
1911111,GerarCR,52416,857,ES,51,17,34,4,Team Random Map
2654018,Chojilovespace,52426,856,US,20,7,13,4,Team Random Map
2143456,filmorg,52461,855,RU,57,27,30,1,Team Random Map
730267,hisensse,52468,854,AR,69,25,44,1,Team Random Map
2634684,TesseracT,52470,854,IN,16,5,11,2,Team Random Map
826956,Bobhenry,52531,851,US,57,22,35,7,Team Random Map
549275,Exponentielles Wachstum,52534,851,DE,42,17,25,1,Team Random Map
2020448,Forgoto Get-Loom,52546,851,NZ,37,14,23,2,Team Random Map
621035,Manu45657,52580,849,NA,11,3,8,0,Team Random Map
2569762,David Sanabria,52582,849,CO,35,12,23,2,Team Random Map
2279192,jmcurci,52585,849,AR,45,17,28,0,Team Random Map
1171690,Kickass,52595,848,FR,37,15,22,5,Team Random Map
2397110,mariocsgazal98,52604,848,AR,28,9,19,10,Team Random Map
2142615,Manuz936153,52607,848,NA,32,11,21,1,Team Random Map
2480413,Terry Mabel,52625,847,US,19,8,11,1,Team Random Map
1918824,Gong,52634,847,FR,31,12,19,1,Team Random Map
2057151,BigGulpsHuh,52645,846,US,52,22,30,0,Team Random Map
438459,RattigerRasierer13,52659,845,DE,15,7,8,1,Team Random Map
2233981,Hagen93,52662,845,DE,56,22,34,2,Team Random Map
2068369,Flocelot,52667,845,NA,105,37,68,6,Team Random Map
1942075,Molotow,52699,843,DE,35,13,22,0,Team Random Map
1105306,Celle,52703,842,DE,103,34,69,5,Team Random Map
525913,errazurizclemente,52707,842,CL,30,8,22,3,Team Random Map
2667977,CHRISTO LE ROI8,52708,842,NA,65,28,37,4,Team Random Map
2427327,jgvido,52726,841,NA,85,29,56,15,Team Random Map
2287584,TheZ,52727,841,TR,32,11,21,0,Team Random Map
2527135,Avascar,52744,840,US,25,8,17,1,Team Random Map
2527103,Cricru,52745,840,FR,10,3,7,0,Team Random Map
1599560,arosegren,52758,840,US,18,5,13,1,Team Random Map
2154068,[LFE] M.Heisenberg,52795,838,FR,35,14,21,0,Team Random Map
2126631,volviK,52796,838,FR,61,26,35,1,Team Random Map
2100813,Gringotomato,52832,836,FR,22,9,13,3,Team Random Map
2661803,mithatcan.tuncay,52842,835,TR,56,20,36,0,Team Random Map
2127814,iskendery ^ ^,52854,835,TR,271,114,157,7,Team Random Map
2107437,WichoChuletas,52855,835,MX,16,8,8,0,Team Random Map
2470777,dj432,52878,833,GB,118,52,66,2,Team Random Map
2129622,lucascornejolc3,52884,833,AR,28,11,17,0,Team Random Map
1706448,Lucifer,52886,833,AR,31,9,22,6,Team Random Map
2610689,map_06,52896,832,AR,20,6,14,0,Team Random Map
2325302,justinscottmichel,52900,832,US,37,12,25,0,Team Random Map
583001,Amyas777,52926,830,NA,16,4,12,4,Team Random Map
2648236,Rimmer,52945,829,GB,11,4,7,0,Team Random Map
1181175,Pityatar,52957,828,FR,11,3,8,0,Team Random Map
757649,ClanKje,52959,828,NA,40,16,24,0,Team Random Map
2547181,Devil Ernie,52964,828,NA,14,6,8,1,Team Random Map
1070274,SergiO,52988,827,ES,54,19,35,4,Team Random Map
1310260,RV Slash,53011,825,AU,49,12,37,0,Team Random Map
2223499,Ernak,53021,824,ES,64,21,43,0,Team Random Map
276451,il-Qanfud,53032,823,CO,54,20,34,4,Team Random Map
2125968,janamen,53041,823,NA,156,52,104,3,Team Random Map
1918244,aymen,53057,822,DE,12,4,8,3,Team Random Map
1205779,Joukii,53060,822,CZ,15,2,13,0,Team Random Map
1098191,HaloTach,53127,814,MX,19,2,17,0,Team Random Map
1942728,Darkeside44,53139,814,NL,29,10,19,2,Team Random Map
2382607,parruski,53160,812,US,36,13,23,0,Team Random Map
1435779,jeriendenblanken,53164,812,NL,12,4,8,1,Team Random Map
2346155,izaro.iruj,53182,810,IT,53,19,34,2,Team Random Map
258082,Straterator,53192,809,DE,44,7,37,2,Team Random Map
2359982,Bigorneau,53196,809,FR,10,3,7,0,Team Random Map
2497169,like29zombies,53234,806,US,16,4,12,0,Team Random Map
2723394,sa3danish,53240,805,KW,13,3,10,2,Team Random Map
575538,Verdusco,53250,804,PE,77,26,51,0,Team Random Map
647100,ARaGon,53290,801,AR,57,18,39,4,Team Random Map
2646029,Rorschach,53305,800,FR,12,2,10,1,Team Random Map
2372277,4M420N14,53310,800,BR,31,9,22,1,Team Random Map
602678,jlrs7,53356,796,NA,167,67,100,9,Team Random Map
1924138,Kachowrc235,53366,796,NA,71,29,42,7,Team Random Map
2584841,kerembyrk,53383,794,NA,18,5,13,0,Team Random Map
2353947,UmustBeQuick,53387,794,CA,38,16,22,0,Team Random Map
2597990,franz6969,53398,793,AT,30,9,21,2,Team Random Map
1303950,Vvojtab,53407,793,CZ,16,2,14,2,Team Random Map
299571,[DoD]ForestSpirit,53413,792,AU,21,7,14,2,Team Random Map
1925516,paXyyy,53431,790,TR,53,23,30,1,Team Random Map
2557877,Dixon Ormous,53439,789,CA,14,4,10,0,Team Random Map
704753,Lorz,53481,785,DE,36,9,27,1,Team Random Map
2625187,Mii,53483,785,ES,54,21,33,1,Team Random Map
1481040,PHA,53522,782,CH,55,18,37,1,Team Random Map
2740854,adamphillipsinbox,53526,781,AU,12,5,7,0,Team Random Map
2237270,luwade3,53539,780,AR,14,3,11,0,Team Random Map
2701993,Femalethor,53548,779,US,10,2,8,0,Team Random Map
2055238,SirPresident765,53554,779,NA,51,20,31,2,Team Random Map
622943,Mahoni2017,53600,774,NA,67,20,47,11,Team Random Map
1869297,sevi85,53607,774,ES,90,31,59,5,Team Random Map
2285322,EricB582,53616,772,NA,25,6,19,8,Team Random Map
1634397,thanhlm,53619,772,VN,49,11,38,0,Team Random Map
1129715,FaizMeister,53620,771,IN,81,35,46,1,Team Random Map
2628585,Tonyshark,53622,771,IT,10,1,9,0,Team Random Map
1493143,空白,53641,770,US,98,35,63,2,Team Random Map
2281832,drokidgamer,53667,767,NA,10,1,9,0,Team Random Map
2627362,Trachoxx,53702,763,CO,29,10,19,1,Team Random Map
2303338,RELIF89,53721,761,NA,33,12,21,2,Team Random Map
2362786,SchoolAunt4187,53729,760,NA,35,11,24,4,Team Random Map
2415927,Ex Milkman,53737,759,NA,16,6,10,0,Team Random Map
2643229,GURN.Zoidbong,53744,758,GB,51,18,33,1,Team Random Map
1921911,thesheriff8605,53754,757,NA,26,7,19,2,Team Random Map
1714303,djcorynorie,53766,756,AU,14,1,13,1,Team Random Map
2040733,musti46774,53823,748,TR,34,8,26,0,Team Random Map
1895334,Emiliano M.V.,53824,748,ES,183,49,134,14,Team Random Map
2450477,Skywalker OG,53834,746,TR,50,17,33,4,Team Random Map
2279428,joaopedrocastanheiramota,53835,746,BR,17,4,13,2,Team Random Map
598151,nosil-49,53844,745,FR,41,11,30,2,Team Random Map
2326373,LavenderOwl4980,53874,741,NA,45,16,29,8,Team Random Map
2546249,FlaminSpaz,53882,739,GB,44,15,29,0,Team Random Map
1852553,Pagano1990,53892,738,AR,34,12,22,2,Team Random Map
442801,Ragnar,53922,732,SK,52,20,32,0,Team Random Map
2048752,Poojan,53950,727,IN,32,8,24,1,Team Random Map
624550,Juniper2817,53991,718,NA,84,28,56,1,Team Random Map
2329647,nikhilsahu37,53995,718,IN,24,5,19,2,Team Random Map
2487275,Fitzy6221,53999,717,NA,20,5,15,0,Team Random Map
966547,Romeo,54006,715,RU,69,22,47,5,Team Random Map
2654794,ENGEIKI,54014,714,CN,11,0,11,0,Team Random Map
2650000,matias_valenzuela,54015,714,CL,16,5,11,0,Team Random Map
1803881,VDO Corneiillus,54018,714,NA,18,5,13,0,Team Random Map
2436343,citheria,54022,713,FR,10,1,9,3,Team Random Map
1372647,MisterOuyhey,54034,712,NA,14,4,10,0,Team Random Map
2133632,TacticoolTim,54063,703,NA,18,3,15,1,Team Random Map
2608700,Tono7910,54107,691,NA,14,2,12,1,Team Random Map
688406,Steffchen_3012_,54118,687,DE,116,35,81,0,Team Random Map
2290428,FiwiPITO,54135,679,NA,16,6,10,0,Team Random Map
1390472,thomas,54139,678,AT,17,4,13,1,Team Random Map
2133330,A muscular hobo,54141,677,NA,21,4,17,1,Team Random Map
2052707,Mikail,54163,665,TR,31,2,29,0,Team Random Map
2319916,GloatingBird270,54203,622,NA,11,1,10,1,Team Random Map
2292594,courtyroy,54223,568,CA,18,0,18,1,Team Random Map
2292587,lady_bug6,54224,565,CA,18,0,18,0,Team Random Map
